,Unnamed: 0,GEOID,B22010e1,B22010m1,B22010e2,B22010m2,B22010e3,B22010m3,B22010e4,B22010m4,B22010e5,B22010m5,B22010e6,B22010m6,B22010e7,B22010m7,OBJECTID
0,0,15000US060816008001,616,115,52,62,0,12,52,62,564,137,124,103,440,135,19001
1,1,15000US060816008002,847,143,53,38,31,32,22,27,794,143,146,76,648,147,19002
2,2,15000US060816008003,898,131,119,92,0,12,119,92,779,147,86,75,693,153,19003
3,3,15000US060816008004,359,110,15,23,15,23,0,12,344,113,44,45,300,114,19004
4,4,15000US060816009001,761,72,19,28,0,12,19,28,742,74,107,43,635,85,19005
5,5,15000US060816009002,626,80,26,25,26,25,0,12,600,80,86,57,514,80,19006
6,6,15000US060816010001,607,101,29,29,8,12,21,26,578,96,140,48,438,97,19007
7,7,15000US060816010002,522,85,6,11,6,11,0,12,516,85,63,41,453,88,19008
8,8,15000US060816010003,656,93,7,12,0,12,7,12,649,93,104,45,545,93,19009
9,9,15000US060816010004,199,51,0,12,0,12,0,12,199,51,40,30,159,52,19010
10,10,15000US060816011001,270,51,0,12,0,12,0,12,270,51,48,30,222,62,19011
11,11,15000US060816011002,297,65,0,12,0,12,0,12,297,65,15,19,282,65,19012
12,12,15000US060816011003,308,71,9,13,0,12,9,13,299,70,72,41,227,65,19013
13,13,15000US060816011004,496,76,16,25,0,12,16,25,480,78,146,67,334,80,19014
14,14,15000US060816011005,531,57,0,12,0,12,0,12,531,57,138,40,393,61,19015
15,15,15000US060816012001,754,155,20,31,0,12,20,31,734,154,54,56,680,162,19016
16,16,15000US060816012002,327,69,34,46,0,12,34,46,293,70,49,49,244,64,19017
17,17,15000US060816012003,484,136,25,31,14,23,11,19,459,140,32,32,427,140,19018
18,18,15000US060816012004,575,118,0,12,0,12,0,12,575,118,68,55,507,120,19019
19,19,15000US060816013001,425,110,44,63,0,12,44,63,381,102,145,80,236,100,19020
20,20,15000US060816013002,760,175,98,82,18,29,80,77,662,175,94,82,568,160,19021
21,21,15000US060816013003,603,168,186,126,34,41,152,127,417,126,164,87,253,111,19022
22,22,15000US060816013004,764,154,50,58,36,54,14,23,714,148,77,75,637,147,19023
23,23,15000US060816014001,486,139,35,45,0,12,35,45,451,135,145,97,306,102,19024
24,24,15000US060816014002,1092,141,121,95,68,77,53,52,971,162,155,98,816,167,19025
25,25,15000US060816014003,564,108,0,12,0,12,0,12,564,108,157,60,407,110,19026
26,26,15000US060816015011,563,91,18,28,0,12,18,28,545,92,62,41,483,105,19027
27,27,15000US060816015012,393,75,7,13,0,12,7,13,386,76,134,62,252,75,19028
28,28,15000US060816015013,398,67,0,12,0,12,0,12,398,67,142,63,256,67,19029
29,29,15000US060816015021,1155,102,38,37,0,12,38,37,1117,110,135,55,982,111,19030
30,30,15000US060816015022,603,77,75,46,18,20,57,42,528,80,76,40,452,80,19031
31,31,15000US060816016011,417,57,34,23,4,6,30,22,383,55,65,27,318,55,19032
32,32,15000US060816016012,457,53,34,24,28,22,6,9,423,54,167,60,256,50,19033
33,33,15000US060816016031,762,105,21,33,0,12,21,33,741,108,146,56,595,110,19034
34,34,15000US060816016032,500,85,0,12,0,12,0,12,500,85,145,58,355,80,19035
35,35,15000US060816016033,628,114,17,19,17,19,0,12,611,114,123,46,488,111,19036
36,36,15000US060816016041,1106,63,0,12,0,12,0,12,1106,63,177,66,929,94,19037
37,37,15000US060816016051,334,81,44,36,12,18,32,31,290,72,103,71,187,57,19038
38,38,15000US060816016052,316,68,0,12,0,12,0,12,316,68,79,43,237,83,19039
39,39,15000US060816016053,625,72,29,39,0,12,29,39,596,74,86,41,510,80,19040
40,40,15000US060816016054,483,80,11,17,11,17,0,12,472,83,71,40,401,87,19041
41,41,15000US060816017001,384,84,0,12,0,12,0,12,384,84,24,21,360,87,19042
42,42,15000US060816017002,513,72,19,21,19,21,0,12,494,72,125,53,369,69,19043
43,43,15000US060816017003,426,76,11,17,11,17,0,12,415,78,92,39,323,88,19044
44,44,15000US060816018001,1197,136,66,65,40,61,26,33,1131,143,377,151,754,153,19045
45,45,15000US060816018002,897,126,53,53,26,36,27,41,844,136,233,90,611,141,19046
46,46,15000US060816019011,348,76,30,27,30,27,0,12,318,72,120,61,198,74,19047
47,47,15000US060816019012,768,100,37,31,10,15,27,28,731,100,180,64,551,106,19048
48,48,15000US060816019013,276,61,0,12,0,12,0,12,276,61,36,29,240,64,19049
49,49,15000US060816019021,796,164,0,12,0,12,0,12,796,164,88,61,708,162,19050
50,50,15000US060816019022,257,67,0,12,0,12,0,12,257,67,45,43,212,73,19051
51,51,15000US060816019023,1119,135,37,43,8,16,29,41,1082,134,140,76,942,157,19052
52,52,15000US060816020001,859,129,0,12,0,12,0,12,859,129,192,100,667,133,19053
53,53,15000US060816020002,369,123,0,12,0,12,0,12,369,123,127,48,242,122,19054
54,54,15000US060816020003,269,104,0,12,0,12,0,12,269,104,30,27,239,103,19055
55,55,15000US060816020004,595,110,0,12,0,12,0,12,595,110,196,103,399,108,19056
56,56,15000US060816020005,350,95,0,12,0,12,0,12,350,95,104,75,246,95,19057
57,57,15000US060816021001,274,59,7,10,7,10,0,12,267,57,89,37,178,56,19058
58,58,15000US060816021002,328,63,26,33,6,9,20,31,302,68,27,17,275,69,19059
59,59,15000US060816021003,354,69,77,38,12,13,65,36,277,70,50,30,227,63,19060
60,60,15000US060816022001,443,137,40,47,40,47,0,12,403,132,124,113,279,103,19061
61,61,15000US060816022002,394,124,11,20,0,12,11,20,383,119,31,37,352,128,19062
62,62,15000US060816022003,822,152,92,85,36,57,56,64,730,170,47,48,683,171,19063
63,63,15000US060816022004,761,157,11,19,0,12,11,19,750,158,218,93,532,170,19064
64,64,15000US060816023001,1118,68,100,60,48,31,52,54,1018,92,242,92,776,113,19065
65,65,15000US060816024001,374,122,0,12,0,12,0,12,374,122,36,42,338,126,19066
66,66,15000US060816024002,700,116,14,23,14,23,0,12,686,113,134,85,552,124,19067
67,67,15000US060816024003,696,127,0,12,0,12,0,12,696,127,224,99,472,158,19068
68,68,15000US060816024004,906,152,12,21,12,21,0,12,894,153,300,120,594,149,19069
69,69,15000US060816025001,564,85,0,12,0,12,0,12,564,85,111,58,453,95,19070
70,70,15000US060816025002,414,85,6,9,6,9,0,12,408,85,142,55,266,81,19071
71,71,15000US060816025003,537,70,30,46,0,12,30,46,507,79,95,40,412,82,19072
72,72,15000US060816026001,361,75,14,23,0,12,14,23,347,77,47,43,300,79,19073
73,73,15000US060816026002,854,107,61,53,30,34,31,39,793,113,123,72,670,111,19074
74,74,15000US060816026003,753,124,0,12,0,12,0,12,753,124,146,79,607,131,19075
75,75,15000US060816026004,734,123,0,12,0,12,0,12,734,123,133,81,601,132,19076
76,76,15000US060816027001,325,82,0,12,0,12,0,12,325,82,28,24,297,80,19077
77,77,15000US060816027002,549,104,18,20,8,12,10,16,531,108,124,56,407,100,19078
78,78,15000US060816027003,468,85,0,12,0,12,0,12,468,85,83,56,385,89,19079
79,79,15000US060816027004,602,89,52,39,43,37,9,15,550,92,40,27,510,94,19080
80,80,15000US060816028001,276,60,12,15,0,12,12,15,264,61,18,19,246,61,19081
81,81,15000US060816028002,938,89,32,26,14,18,18,20,906,90,230,69,676,102,19082
82,82,15000US060816028003,285,58,9,15,0,12,9,15,276,57,34,28,242,61,19083
83,83,15000US060816029001,955,114,7,11,0,12,7,11,948,114,97,63,851,113,19084
84,84,15000US060816029002,619,91,14,21,14,21,0,12,605,92,115,53,490,104,19085
85,85,15000US060816030001,607,79,0,12,0,12,0,12,607,79,128,60,479,92,19086
86,86,15000US060816030002,358,78,0,12,0,12,0,12,358,78,45,35,313,76,19087
87,87,15000US060816030003,238,52,17,19,8,13,9,15,221,54,9,14,212,55,19088
88,88,15000US060816030004,625,93,21,20,17,19,4,6,604,94,57,40,547,93,19089
89,89,15000US060816031001,734,62,7,10,0,12,7,10,727,64,48,31,679,75,19090
90,90,15000US060816031002,493,58,0,12,0,12,0,12,493,58,126,50,367,65,19091
91,91,15000US060816032001,489,74,8,13,8,13,0,12,481,73,90,45,391,80,19092
92,92,15000US060816032002,221,61,0,12,0,12,0,12,221,61,52,37,169,55,19093
93,93,15000US060816032003,392,74,18,23,7,15,11,20,374,72,76,40,298,80,19094
94,94,15000US060816032004,255,57,0,12,0,12,0,12,255,57,16,20,239,55,19095
95,95,15000US060816033001,837,120,17,25,17,25,0,12,820,122,170,83,650,137,19096
96,96,15000US060816033002,772,114,11,19,11,19,0,12,761,116,126,62,635,124,19097
97,97,15000US060816033003,749,95,0,12,0,12,0,12,749,95,122,63,627,103,19098
98,98,15000US060816034001,539,125,0,12,0,12,0,12,539,125,60,40,479,126,19099
99,99,15000US060816034002,462,90,0,12,0,12,0,12,462,90,116,80,346,100,19100
100,100,15000US060816034003,583,107,76,76,18,29,58,86,507,90,185,74,322,108,19101
101,101,15000US060816034004,527,102,23,38,22,35,1,28,504,107,122,80,382,115,19102
102,102,15000US060816037001,847,110,0,12,0,12,0,12,847,110,138,59,709,110,19103
103,103,15000US060816037002,882,81,24,23,8,13,16,18,858,82,174,65,684,87,19104
104,104,15000US060816038011,1179,99,35,33,0,12,35,33,1144,102,146,77,998,131,19105
105,105,15000US060816038021,1166,97,13,19,0,12,13,19,1153,96,335,88,818,111,19106
106,106,15000US060816038022,706,87,0,12,0,12,0,12,706,87,108,61,598,91,19107
107,107,15000US060816039001,279,81,0,12,0,12,0,12,279,81,50,41,229,91,19108
108,108,15000US060816039002,517,120,10,16,10,16,0,12,507,123,118,98,389,116,19109
109,109,15000US060816039003,256,64,17,27,0,12,17,27,239,58,83,42,156,54,19110
110,110,15000US060816039004,261,61,19,31,0,12,19,31,242,66,79,47,163,61,19111
111,111,15000US060816039005,285,79,0,12,0,12,0,12,285,79,102,85,183,64,19112
112,112,15000US060816039006,491,98,0,12,0,12,0,12,491,98,41,47,450,102,19113
113,113,15000US060816040001,263,49,0,12,0,12,0,12,263,49,27,19,236,49,19114
114,114,15000US060816040002,391,66,0,12,0,12,0,12,391,66,108,56,283,63,19115
115,115,15000US060816040003,456,50,0,12,0,12,0,12,456,50,105,43,351,66,19116
116,116,15000US060816041011,543,136,92,84,0,12,92,84,451,136,64,77,387,120,19117
117,117,15000US060816041012,883,162,42,43,13,22,29,35,841,170,45,40,796,171,19118
118,118,15000US060816041013,1081,188,175,115,13,21,162,114,906,163,216,139,690,171,19119
119,119,15000US060816041021,1579,87,55,29,15,17,40,25,1524,86,203,64,1321,102,19120
120,120,15000US060816042001,291,82,0,12,0,12,0,12,291,82,78,45,213,78,19121
121,121,15000US060816042002,232,75,12,18,0,12,12,18,220,76,58,49,162,73,19122
122,122,15000US060816042003,587,94,66,49,23,27,43,44,521,95,89,46,432,103,19123
123,123,15000US060816044001,693,106,41,47,26,41,15,20,652,114,50,34,602,122,19124
124,124,15000US060816044002,430,73,0,12,0,12,0,12,430,73,83,43,347,66,19125
125,125,15000US060816044003,627,103,0,12,0,12,0,12,627,103,103,56,524,96,19126
126,126,15000US060816045001,236,63,6,10,0,12,6,10,230,64,58,43,172,59,19127
127,127,15000US060816045002,282,49,11,17,0,12,11,17,271,52,0,12,271,52,19128
128,128,15000US060816045003,781,81,7,11,0,12,7,11,774,81,213,64,561,82,19129
129,129,15000US060816046001,533,47,0,12,0,12,0,12,533,47,108,36,425,55,19130
130,130,15000US060816046002,421,46,0,12,0,12,0,12,421,46,61,25,360,49,19131
131,131,15000US060816047001,593,59,4,7,0,12,4,7,589,59,96,33,493,69,19132
132,132,15000US060816047002,361,53,0,12,0,12,0,12,361,53,30,20,331,54,19133
133,133,15000US060816048001,712,93,35,34,0,12,35,34,677,106,107,76,570,102,19134
134,134,15000US060816048002,506,91,17,26,0,12,17,26,489,99,144,67,345,92,19135
135,135,15000US060816048003,666,102,0,12,0,12,0,12,666,102,240,72,426,94,19136
136,136,15000US060816049001,687,63,0,12,0,12,0,12,687,63,106,48,581,72,19137
137,137,15000US060816049002,530,57,11,16,11,16,0,12,519,60,132,50,387,68,19138
138,138,15000US060816050001,909,138,0,12,0,12,0,12,909,138,163,84,746,147,19139
139,139,15000US060816050002,358,77,0,12,0,12,0,12,358,77,0,12,358,77,19140
140,140,15000US060816050003,959,104,0,12,0,12,0,12,959,104,170,77,789,129,19141
141,141,15000US060816050004,359,92,0,12,0,12,0,12,359,92,30,35,329,93,19142
142,142,15000US060816050005,310,78,0,12,0,12,0,12,310,78,26,31,284,77,19143
143,143,15000US060816051001,315,62,13,20,13,20,0,12,302,63,31,23,271,66,19144
144,144,15000US060816051002,1105,73,22,25,0,12,22,25,1083,75,180,76,903,96,19145
145,145,15000US060816052001,372,54,11,18,0,12,11,18,361,55,61,41,300,59,19146
146,146,15000US060816052002,365,50,0,12,0,12,0,12,365,50,29,27,336,54,19147
147,147,15000US060816052003,250,48,0,12,0,12,0,12,250,48,13,21,237,54,19148
148,148,15000US060816052004,275,45,0,12,0,12,0,12,275,45,22,23,253,50,19149
149,149,15000US060816053001,602,82,0,12,0,12,0,12,602,82,44,33,558,88,19150
150,150,15000US060816053002,614,82,27,27,20,23,7,13,587,82,106,46,481,84,19151
151,151,15000US060816053003,388,85,0,12,0,12,0,12,388,85,68,36,320,87,19152
152,152,15000US060816053004,241,57,0,12,0,12,0,12,241,57,23,23,218,62,19153
153,153,15000US060816054001,297,63,0,12,0,12,0,12,297,63,61,42,236,78,19154
154,154,15000US060816054002,387,91,13,22,0,12,13,22,374,94,93,84,281,71,19155
155,155,15000US060816054003,653,144,15,25,15,25,0,12,638,143,83,54,555,153,19156
156,156,15000US060816054004,427,92,16,25,0,12,16,25,411,93,43,39,368,96,19157
157,157,15000US060816054005,677,144,14,23,14,23,0,12,663,141,35,29,628,148,19158
158,158,15000US060816055001,1674,149,38,42,19,31,19,32,1636,151,146,70,1490,162,19159
159,159,15000US060816055002,309,95,17,26,17,26,0,12,292,95,28,31,264,93,19160
160,160,15000US060816055003,768,157,0,12,0,12,0,12,768,157,115,81,653,151,19161
161,161,15000US060816056001,314,53,0,12,0,12,0,12,314,53,32,29,282,55,19162
162,162,15000US060816056002,332,61,0,12,0,12,0,12,332,61,92,49,240,64,19163
163,163,15000US060816056003,377,74,0,12,0,12,0,12,377,74,50,28,327,75,19164
164,164,15000US060816056004,911,86,0,12,0,12,0,12,911,86,194,65,717,96,19165
165,165,15000US060816057001,332,67,0,12,0,12,0,12,332,67,48,34,284,71,19166
166,166,15000US060816057002,447,70,0,12,0,12,0,12,447,70,67,40,380,74,19167
167,167,15000US060816057003,531,66,10,17,10,17,0,12,521,66,96,46,425,70,19168
168,168,15000US060816057004,461,67,0,12,0,12,0,12,461,67,34,30,427,72,19169
169,169,15000US060816058001,248,55,0,12,0,12,0,12,248,55,54,30,194,54,19170
170,170,15000US060816058002,426,63,0,12,0,12,0,12,426,63,81,46,345,67,19171
171,171,15000US060816058003,298,57,0,12,0,12,0,12,298,57,58,36,240,54,19172
172,172,15000US060816059001,968,133,28,33,28,33,0,12,940,135,237,93,703,126,19173
173,173,15000US060816059002,697,126,87,91,0,12,87,91,610,120,111,64,499,122,19174
174,174,15000US060816059003,920,143,23,32,19,30,4,9,897,144,167,92,730,142,19175
175,175,15000US060816060001,1196,172,43,67,0,12,43,67,1153,184,198,104,955,187,19176
176,176,15000US060816060002,928,174,281,131,34,53,247,110,647,156,70,50,577,162,19177
177,177,15000US060816061001,549,92,0,12,0,12,0,12,549,92,39,29,510,96,19178
178,178,15000US060816061002,401,79,11,19,11,19,0,12,390,77,85,64,305,70,19179
179,179,15000US060816061003,360,78,47,47,18,29,29,35,313,91,50,40,263,90,19180
180,180,15000US060816062001,608,171,84,97,25,31,59,89,524,159,10,18,514,157,19181
181,181,15000US060816062002,664,157,195,110,95,76,100,87,469,139,147,73,322,141,19182
182,182,15000US060816062003,441,125,55,70,55,70,0,12,386,122,109,85,277,114,19183
183,183,15000US060816062004,543,109,38,59,0,12,38,59,505,107,57,51,448,104,19184
184,184,15000US060816063001,649,78,46,35,15,17,31,30,603,86,118,55,485,83,19185
185,185,15000US060816063002,470,89,8,13,0,12,8,13,462,87,119,44,343,97,19186
186,186,15000US060816063003,712,89,63,58,0,12,63,58,649,91,148,50,501,94,19187
187,187,15000US060816064001,620,133,8,15,0,12,8,15,612,133,30,34,582,140,19188
188,188,15000US060816064002,281,67,0,12,0,12,0,12,281,67,50,36,231,72,19189
189,189,15000US060816064003,651,148,0,12,0,12,0,12,651,148,197,106,454,113,19190
190,190,15000US060816064004,978,156,21,36,0,12,21,36,957,163,135,85,822,166,19191
191,191,15000US060816065001,206,38,0,12,0,12,0,12,206,38,17,19,189,43,19192
192,192,15000US060816065002,369,51,11,16,11,16,0,12,358,53,36,30,322,58,19193
193,193,15000US060816065003,301,49,0,12,0,12,0,12,301,49,31,23,270,56,19194
194,194,15000US060816065004,375,61,0,12,0,12,0,12,375,61,65,34,310,58,19195
195,195,15000US060816066001,504,68,26,29,0,12,26,29,478,68,120,46,358,68,19196
196,196,15000US060816066002,452,68,11,19,11,19,0,12,441,66,42,25,399,70,19197
197,197,15000US060816066003,496,64,0,12,0,12,0,12,496,64,107,49,389,67,19198
198,198,15000US060816067001,309,35,0,12,0,12,0,12,309,35,58,27,251,39,19199
199,199,15000US060816067002,646,49,0,12,0,12,0,12,646,49,108,31,538,54,19200
200,200,15000US060816068001,458,52,0,12,0,12,0,12,458,52,78,37,380,64,19201
201,201,15000US060816068002,811,72,0,12,0,12,0,12,811,72,80,44,731,81,19202
202,202,15000US060816069001,303,40,5,7,0,12,5,7,298,41,35,22,263,40,19203
203,203,15000US060816069002,614,43,0,12,0,12,0,12,614,43,106,39,508,54,19204
204,204,15000US060816070001,275,57,0,12,0,12,0,12,275,57,25,40,250,50,19205
205,205,15000US060816070002,1109,67,24,27,16,24,8,13,1085,76,131,51,954,85,19206
206,206,15000US060816071001,300,55,0,12,0,12,0,12,300,55,72,42,228,67,19207
207,207,15000US060816071002,386,52,0,12,0,12,0,12,386,52,89,40,297,54,19208
208,208,15000US060816071003,393,53,0,12,0,12,0,12,393,53,95,51,298,55,19209
209,209,15000US060816072001,976,86,16,24,0,12,16,24,960,91,145,71,815,112,19210
210,210,15000US060816072002,742,80,0,12,0,12,0,12,742,80,183,76,559,92,19211
211,211,15000US060816073001,434,44,0,12,0,12,0,12,434,44,33,22,401,49,19212
212,212,15000US060816073002,696,74,0,12,0,12,0,12,696,74,140,62,556,75,19213
213,213,15000US060816073003,197,37,0,12,0,12,0,12,197,37,40,26,157,39,19214
214,214,15000US060816074001,875,101,11,17,0,12,11,17,864,99,84,45,780,93,19215
215,215,15000US060816074002,302,85,54,75,0,12,54,75,248,64,66,40,182,56,19216
216,216,15000US060816074003,709,94,21,23,11,16,10,14,688,96,272,87,416,104,19217
217,217,15000US060816075001,1606,77,97,48,12,17,85,45,1509,92,200,64,1309,108,19218
218,218,15000US060816076001,358,51,0,12,0,12,0,12,358,51,36,34,322,53,19219
219,219,15000US060816076002,289,64,22,34,22,34,0,12,267,61,24,23,243,64,19220
220,220,15000US060816076003,325,61,8,12,8,12,0,12,317,65,13,14,304,64,19221
221,221,15000US060816076004,287,67,0,12,0,12,0,12,287,67,53,30,234,66,19222
222,222,15000US060816077011,551,81,42,55,33,53,9,15,509,94,106,63,403,85,19223
223,223,15000US060816077012,191,54,0,12,0,12,0,12,191,54,50,28,141,51,19224
224,224,15000US060816077013,443,66,47,49,0,12,47,49,396,77,81,54,315,72,19225
225,225,15000US060816077021,429,42,6,9,6,9,0,12,423,42,119,43,304,48,19226
226,226,15000US060816077022,369,45,29,25,11,14,18,18,340,48,111,36,229,51,19227
227,227,15000US060816078001,502,52,8,10,0,12,8,10,494,51,80,27,414,54,19228
228,228,15000US060816078002,488,47,35,32,7,11,28,31,453,52,82,30,371,59,19229
229,229,15000US060816079001,513,58,0,12,0,12,0,12,513,58,95,42,418,67,19230
230,230,15000US060816079002,450,76,11,17,0,12,11,17,439,74,50,30,389,76,19231
231,231,15000US060816079003,695,85,9,16,0,12,9,16,686,87,65,36,621,92,19232
232,232,15000US060816080011,855,82,8,13,8,13,0,12,847,83,63,37,784,92,19233
233,233,15000US060816080012,751,91,0,12,0,12,0,12,751,91,94,63,657,108,19234
234,234,15000US060816080021,778,88,0,12,0,12,0,12,778,88,125,59,653,100,19235
235,235,15000US060816080022,308,56,0,12,0,12,0,12,308,56,50,27,258,59,19236
236,236,15000US060816080023,278,55,9,12,0,12,9,12,269,56,17,20,252,54,19237
237,237,15000US060816080041,700,157,44,50,0,12,44,50,656,165,36,43,620,168,19238
238,238,15000US060816080042,585,92,0,12,0,12,0,12,585,92,89,60,496,94,19239
239,239,15000US060816080043,912,153,0,12,0,12,0,12,912,153,14,23,898,156,19240
240,240,15000US060816080044,944,131,0,12,0,12,0,12,944,131,70,55,874,136,19241
241,241,15000US060816080131,846,76,12,18,0,12,12,18,834,75,105,51,729,86,19242
242,242,15000US060816080132,416,78,0,12,0,12,0,12,416,78,22,24,394,81,19243
243,243,15000US060816080133,423,69,0,12,0,12,0,12,423,69,9,15,414,68,19244
244,244,15000US060816080231,300,44,0,12,0,12,0,12,300,44,35,18,265,45,19245
245,245,15000US060816080232,608,36,13,17,13,17,0,12,595,37,54,27,541,40,19246
246,246,15000US060816081001,1437,42,39,57,39,57,0,12,1398,73,265,78,1133,90,19247
247,247,15000US060816082001,1349,64,21,24,15,22,6,11,1328,71,198,63,1130,83,19248
248,248,15000US060816083001,731,68,0,12,0,12,0,12,731,68,83,51,648,85,19249
249,249,15000US060816083002,685,78,0,12,0,12,0,12,685,78,82,42,603,84,19250
250,250,15000US060816084001,971,135,60,69,23,36,37,59,911,145,120,66,791,156,19251
251,251,15000US060816084002,750,135,70,81,27,45,43,69,680,131,75,77,605,122,19252
252,252,15000US060816084003,454,144,69,70,13,20,56,67,385,132,107,66,278,141,19253
253,253,15000US060816085011,373,62,0,12,0,12,0,12,373,62,87,40,286,67,19254
254,254,15000US060816085012,576,86,0,12,0,12,0,12,576,86,115,54,461,86,19255
255,255,15000US060816085013,385,63,22,23,22,23,0,12,363,62,11,17,352,64,19256
256,256,15000US060816085014,324,61,9,15,9,15,0,12,315,60,73,40,242,67,19257
257,257,15000US060816085021,1180,54,33,28,28,25,5,11,1147,60,96,46,1051,75,19258
258,258,15000US060816086001,310,51,22,19,15,15,7,11,288,55,69,33,219,62,19259
259,259,15000US060816086002,366,44,11,18,0,12,11,18,355,45,61,34,294,46,19260
260,260,15000US060816086003,1029,89,20,22,0,12,20,22,1009,90,134,59,875,96,19261
261,261,15000US060816087001,632,87,27,32,0,12,27,32,605,93,38,37,567,93,19262
262,262,15000US060816087002,597,101,0,12,0,12,0,12,597,101,40,41,557,101,19263
263,263,15000US060816087003,390,93,14,22,0,12,14,22,376,91,102,64,274,74,19264
264,264,15000US060816087004,351,71,0,12,0,12,0,12,351,71,110,70,241,70,19265
265,265,15000US060816087005,637,99,0,12,0,12,0,12,637,99,119,82,518,108,19266
266,266,15000US060816088001,495,90,12,20,12,20,0,12,483,91,85,49,398,111,19267
267,267,15000US060816088002,432,89,0,12,0,12,0,12,432,89,100,80,332,87,19268
268,268,15000US060816088003,223,62,0,12,0,12,0,12,223,62,49,44,174,55,19269
269,269,15000US060816088004,336,66,0,12,0,12,0,12,336,66,48,38,288,66,19270
270,270,15000US060816088005,614,89,33,47,33,47,0,12,581,94,147,66,434,91,19271
271,271,15000US060816089001,433,82,0,12,0,12,0,12,433,82,45,43,388,88,19272
272,272,15000US060816089002,905,156,0,12,0,12,0,12,905,156,179,110,726,141,19273
273,273,15000US060816089003,1347,155,18,29,18,29,0,12,1329,159,173,80,1156,176,19274
274,274,15000US060816089004,259,60,0,12,0,12,0,12,259,60,87,52,172,70,19275
275,275,15000US060816090001,423,75,8,14,8,14,0,12,415,73,88,54,327,70,19276
276,276,15000US060816090002,530,73,0,12,0,12,0,12,530,73,121,67,409,67,19277
277,277,15000US060816091001,293,51,26,24,0,12,26,24,267,43,53,25,214,42,19278
278,278,15000US060816091002,275,33,16,22,0,12,16,22,259,35,39,20,220,39,19279
279,279,15000US060816092011,453,58,9,13,9,13,0,12,444,59,76,41,368,64,19280
280,280,15000US060816092012,570,80,0,12,0,12,0,12,570,80,135,59,435,85,19281
281,281,15000US060816092013,565,58,52,34,24,26,28,35,513,63,102,54,411,68,19282
282,282,15000US060816092021,658,102,0,12,0,12,0,12,658,102,59,32,599,101,19283
283,283,15000US060816092022,1287,101,38,31,22,25,16,18,1249,101,143,71,1106,109,19284
284,284,15000US060816093001,557,63,8,12,8,12,0,12,549,63,71,38,478,71,19285
285,285,15000US060816093002,691,58,0,12,0,12,0,12,691,58,105,48,586,73,19286
286,286,15000US060816094001,1113,53,0,12,0,12,0,12,1113,53,202,83,911,81,19287
287,287,15000US060816095001,664,76,0,12,0,12,0,12,664,76,56,34,608,83,19288
288,288,15000US060816095002,1078,70,0,12,0,12,0,12,1078,70,148,44,930,81,19289
289,289,15000US060816096011,1168,58,32,37,0,12,32,37,1136,69,115,49,1021,77,19290
290,290,15000US060816096021,678,23,0,12,0,12,0,12,678,23,113,36,565,42,19291
291,291,15000US060816096031,708,97,0,12,0,12,0,12,708,97,52,47,656,100,19292
292,292,15000US060816096032,525,83,0,12,0,12,0,12,525,83,222,68,303,77,19293
293,293,15000US060816096033,498,88,0,12,0,12,0,12,498,88,105,63,393,105,19294
294,294,15000US060816096034,250,82,0,12,0,12,0,12,250,82,18,28,232,78,19295
295,295,15000US060816097001,753,74,0,12,0,12,0,12,753,74,107,47,646,76,19296
296,296,15000US060816097002,925,69,0,12,0,12,0,12,925,69,159,57,766,74,19297
297,297,15000US060816098001,343,60,8,13,8,13,0,12,335,60,9,15,326,58,19298
298,298,15000US060816098002,616,76,8,13,0,12,8,13,608,77,69,39,539,81,19299
299,299,15000US060816098003,266,50,0,12,0,12,0,12,266,50,59,38,207,54,19300
300,300,15000US060816098004,469,68,0,12,0,12,0,12,469,68,57,35,412,69,19301
301,301,15000US060816099001,408,51,0,12,0,12,0,12,408,51,72,41,336,52,19302
302,302,15000US060816099002,674,72,0,12,0,12,0,12,674,72,78,41,596,73,19303
303,303,15000US060816100001,1019,92,0,12,0,12,0,12,1019,92,136,54,883,97,19304
304,304,15000US060816100002,416,68,0,12,0,12,0,12,416,68,109,48,307,73,19305
305,305,15000US060816100003,638,89,0,12,0,12,0,12,638,89,85,71,553,102,19306
306,306,15000US060816101001,925,44,28,26,0,12,28,26,897,51,126,46,771,66,19307
307,307,15000US060816102011,393,92,150,70,49,50,101,67,243,73,39,46,204,61,19308
308,308,15000US060816102012,402,83,63,61,0,12,63,61,339,73,124,70,215,57,19309
309,309,15000US060816102013,286,77,32,38,0,12,32,38,254,77,17,20,237,74,19310
310,310,15000US060816102014,689,105,43,36,0,12,43,36,646,102,126,55,520,114,19311
311,311,15000US060816102021,828,74,86,49,18,29,68,38,742,86,145,50,597,89,19312
312,312,15000US060816102031,383,61,73,43,9,15,64,41,310,62,51,26,259,57,19313
313,313,15000US060816102032,657,64,128,49,45,31,83,44,529,60,81,34,448,59,19314
314,314,15000US060816103021,923,56,25,18,20,15,5,9,898,58,162,55,736,76,19315
315,315,15000US060816103031,656,115,0,12,0,12,0,12,656,115,56,57,600,124,19316
316,316,15000US060816103032,520,84,0,12,0,12,0,12,520,84,81,50,439,96,19317
317,317,15000US060816103033,1183,123,0,12,0,12,0,12,1183,123,16,27,1167,124,19318
318,318,15000US060816103034,894,129,0,12,0,12,0,12,894,129,80,62,814,127,19319
319,319,15000US060816103041,777,96,0,12,0,12,0,12,777,96,84,37,693,99,19320
320,320,15000US060816103042,784,84,21,24,12,19,9,15,763,83,88,46,675,85,19321
321,321,15000US060816103043,337,68,0,12,0,12,0,12,337,68,68,47,269,53,19322
322,322,15000US060816104001,927,125,49,40,40,36,9,14,878,129,228,105,650,139,19323
323,323,15000US060816104002,771,116,128,74,21,23,107,71,643,99,151,57,492,94,19324
324,324,15000US060816105001,334,92,63,48,9,14,54,45,271,85,33,31,238,87,19325
325,325,15000US060816105002,357,87,68,51,18,24,50,43,289,75,38,28,251,76,19326
326,326,15000US060816105003,152,62,21,25,9,14,12,21,131,65,15,17,116,68,19327
327,327,15000US060816105004,535,98,6,14,0,12,6,14,529,100,55,33,474,107,19328
328,328,15000US060816106011,554,112,146,75,17,20,129,72,408,104,72,46,336,108,19329
329,329,15000US060816106012,603,124,10,15,0,12,10,15,593,123,129,59,464,130,19330
330,330,15000US060816106013,520,116,50,43,18,22,32,39,470,117,48,35,422,120,19331
331,331,15000US060816106021,324,60,0,12,0,12,0,12,324,60,33,28,291,62,19332
332,332,15000US060816106022,330,52,0,12,0,12,0,12,330,52,67,35,263,55,19333
333,333,15000US060816106023,561,77,35,55,0,12,35,55,526,86,105,40,421,92,19334
334,334,15000US060816107001,1035,156,43,48,0,12,43,48,992,164,308,114,684,165,19335
335,335,15000US060816107002,1128,160,60,58,18,28,42,63,1068,165,144,101,924,172,19336
336,336,15000US060816108001,807,123,2,16,0,12,2,16,805,124,34,28,771,126,19337
337,337,15000US060816108002,881,118,33,34,12,19,21,26,848,122,213,81,635,131,19338
338,338,15000US060816109001,725,112,78,74,21,20,57,69,647,133,206,84,441,137,19339
339,339,15000US060816109002,1005,149,71,56,31,35,40,45,934,157,110,105,824,159,19340
340,340,15000US060816109003,409,126,15,26,0,12,15,26,394,128,11,18,383,127,19341
341,341,15000US060816109004,404,76,26,42,26,42,0,12,378,88,103,72,275,88,19342
342,342,15000US060816110001,521,110,0,12,0,12,0,12,521,110,63,52,458,122,19343
343,343,15000US060816110002,470,78,0,12,0,12,0,12,470,78,74,43,396,78,19344
344,344,15000US060816110003,359,74,0,12,0,12,0,12,359,74,57,46,302,74,19345
345,345,15000US060816110004,970,116,0,12,0,12,0,12,970,116,159,83,811,136,19346
346,346,15000US060816111001,947,115,17,25,17,25,0,12,930,114,261,87,669,118,19347
347,347,15000US060816111002,781,124,0,12,0,12,0,12,781,124,200,124,581,121,19348
348,348,15000US060816111003,597,112,0,12,0,12,0,12,597,112,95,71,502,115,19349
349,349,15000US060816112001,1061,59,16,23,6,11,10,19,1045,61,225,63,820,91,19350
350,350,15000US060816113001,571,76,0,12,0,12,0,12,571,76,28,24,543,81,19351
351,351,15000US060816113002,730,81,44,39,9,13,35,33,686,80,172,66,514,74,19352
352,352,15000US060816113003,237,45,0,12,0,12,0,12,237,45,53,32,184,51,19353
353,353,15000US060816113004,481,86,4,8,0,12,4,8,477,83,50,33,427,86,19354
354,354,15000US060816114001,225,42,0,12,0,12,0,12,225,42,40,33,185,49,19355
355,355,15000US060816114002,261,72,0,12,0,12,0,12,261,72,21,24,240,73,19356
356,356,15000US060816114003,459,78,0,12,0,12,0,12,459,78,109,56,350,78,19357
357,357,15000US060816114004,466,73,15,19,0,12,15,19,451,72,64,42,387,78,19358
358,358,15000US060816115001,215,36,0,12,0,12,0,12,215,36,29,18,186,39,19359
359,359,15000US060816115002,343,58,0,12,0,12,0,12,343,58,57,27,286,55,19360
360,360,15000US060816115003,362,39,4,7,0,12,4,7,358,41,105,40,253,44,19361
361,361,15000US060816116001,419,51,0,12,0,12,0,12,419,51,62,39,357,56,19362
362,362,15000US060816116002,374,42,0,12,0,12,0,12,374,42,74,36,300,41,19363
363,363,15000US060816117001,518,87,130,67,8,13,122,66,388,78,141,46,247,75,19364
364,364,15000US060816117002,478,88,59,37,33,28,26,26,419,97,45,24,374,96,19365
365,365,15000US060816117003,375,77,82,52,12,20,70,50,293,81,66,29,227,80,19366
366,366,15000US060816117004,0,12,0,12,0,12,0,12,0,12,0,12,0,12,19367
367,367,15000US060816118001,387,55,68,37,23,19,45,31,319,59,129,47,190,49,19368
368,368,15000US060816118002,445,61,102,33,36,21,66,32,343,56,88,39,255,59,19369
369,369,15000US060816119001,438,149,86,79,0,12,86,79,352,148,0,12,352,148,19370
370,370,15000US060816119002,364,113,85,76,39,52,46,58,279,93,58,42,221,88,19371
371,371,15000US060816119003,281,93,0,12,0,12,0,12,281,93,45,47,236,91,19372
372,372,15000US060816119004,298,122,0,12,0,12,0,12,298,122,53,42,245,118,19373
373,373,15000US060816119005,726,158,72,71,58,66,14,22,654,147,70,55,584,139,19374
374,374,15000US060816119006,530,120,25,40,0,12,25,40,505,120,117,85,388,131,19375
375,375,15000US060816120001,358,90,58,49,9,15,49,46,300,91,42,38,258,93,19376
376,376,15000US060816120002,561,110,122,87,50,59,72,66,439,120,93,57,346,116,19377
377,377,15000US060816120003,265,81,25,26,11,20,14,16,240,82,53,40,187,81,19378
378,378,15000US060816120004,358,91,58,61,0,12,58,61,300,84,106,59,194,76,19379
379,379,15000US060816121001,406,90,0,12,0,12,0,12,406,90,54,45,352,102,19380
380,380,15000US060816121002,718,134,79,62,0,12,79,62,639,128,112,81,527,123,19381
381,381,15000US060816121003,498,133,37,59,0,12,37,59,461,133,108,65,353,124,19382
382,382,15000US060816121004,253,113,124,102,75,84,49,58,129,73,32,47,97,69,19383
383,383,15000US060816121005,869,193,150,108,0,12,150,108,719,191,132,106,587,192,19384
384,384,15000US060816125001,514,109,0,12,0,12,0,12,514,109,39,38,475,104,19385
385,385,15000US060816125002,430,110,0,12,0,12,0,12,430,110,77,66,353,105,19386
386,386,15000US060816125003,926,132,0,12,0,12,0,12,926,132,90,73,836,145,19387
387,387,15000US060816126001,401,90,0,12,0,12,0,12,401,90,95,62,306,81,19388
388,388,15000US060816126002,708,117,0,12,0,12,0,12,708,117,34,33,674,118,19389
389,389,15000US060816126003,432,96,30,26,14,24,16,27,402,97,96,78,306,74,19390
390,390,15000US060816126004,477,102,0,12,0,12,0,12,477,102,0,12,477,102,19391
391,391,15000US060816127001,324,33,13,20,13,20,0,12,311,33,24,17,287,35,19392
392,392,15000US060816127002,409,40,0,12,0,12,0,12,409,40,77,22,332,42,19393
393,393,15000US060816128001,542,51,0,12,0,12,0,12,542,51,109,45,433,56,19394
394,394,15000US060816128002,443,56,11,17,0,12,11,17,432,58,59,34,373,61,19395
395,395,15000US060816129001,620,63,0,12,0,12,0,12,620,63,105,48,515,68,19396
396,396,15000US060816129002,251,40,0,12,0,12,0,12,251,40,35,31,216,40,19397
397,397,15000US060816129003,299,48,0,12,0,12,0,12,299,48,56,32,243,56,19398
398,398,15000US060816129004,547,86,0,12,0,12,0,12,547,86,120,52,427,83,19399
399,399,15000US060816130001,712,87,0,12,0,12,0,12,712,87,77,37,635,86,19400
400,400,15000US060816130002,707,86,32,40,0,12,32,40,675,84,134,49,541,87,19401
401,401,15000US060816132001,564,90,0,12,0,12,0,12,564,90,52,47,512,102,19402
402,402,15000US060816132002,576,89,0,12,0,12,0,12,576,89,121,79,455,88,19403
403,403,15000US060816132003,460,78,0,12,0,12,0,12,460,78,115,52,345,81,19404
404,404,15000US060816132004,772,113,0,12,0,12,0,12,772,113,215,76,557,131,19405
405,405,15000US060816132005,250,61,0,12,0,12,0,12,250,61,59,36,191,61,19406
406,406,15000US060816133001,567,60,0,12,0,12,0,12,567,60,119,45,448,66,19407
407,407,15000US060816133002,379,62,0,12,0,12,0,12,379,62,68,28,311,60,19408
408,408,15000US060816134001,414,63,0,12,0,12,0,12,414,63,49,33,365,69,19409
409,409,15000US060816134002,244,47,0,12,0,12,0,12,244,47,42,24,202,46,19410
410,410,15000US060816134003,501,66,0,12,0,12,0,12,501,66,75,41,426,66,19411
411,411,15000US060816135011,826,104,41,65,0,12,41,65,785,113,167,65,618,116,19412
412,412,15000US060816135012,812,101,19,31,0,12,19,31,793,102,239,94,554,120,19413
413,413,15000US060816135021,709,147,0,12,0,12,0,12,709,147,97,74,612,150,19414
414,414,15000US060816135022,431,96,0,12,0,12,0,12,431,96,49,36,382,96,19415
415,415,15000US060816135023,587,156,31,37,0,12,31,37,556,156,58,76,498,137,19416
416,416,15000US060816135024,608,173,16,25,0,12,16,25,592,172,44,43,548,174,19417
417,417,15000US060816136001,1067,158,0,12,0,12,0,12,1067,158,238,117,829,172,19418
418,418,15000US060816136002,619,115,0,12,0,12,0,12,619,115,58,84,561,124,19419
419,419,15000US060816136003,350,90,0,12,0,12,0,12,350,90,82,62,268,91,19420
420,420,15000US060816136004,261,93,75,73,19,31,56,64,186,70,64,53,122,67,19421
421,421,15000US060816137001,1135,174,108,109,28,47,80,100,1027,151,244,102,783,174,19422
422,422,15000US060816137002,295,105,0,12,0,12,0,12,295,105,55,45,240,110,19423
423,423,15000US060816137003,379,127,18,30,0,12,18,30,361,129,116,107,245,101,19424
424,424,15000US060816137004,795,137,0,12,0,12,0,12,795,137,179,112,616,111,19425
425,425,15000US060816137005,1102,154,37,40,18,29,19,29,1065,158,180,89,885,169,19426
426,426,15000US060816138001,267,79,0,12,0,12,0,12,267,79,8,13,259,80,19427
427,427,15000US060816138002,262,81,8,15,0,12,8,15,254,79,20,24,234,77,19428
428,428,15000US060816138003,356,103,0,12,0,12,0,12,356,103,130,73,226,82,19429
429,429,15000US060816138004,496,120,42,43,0,12,42,43,454,112,118,72,336,105,19430
430,430,15000US060816139001,235,67,0,12,0,12,0,12,235,67,0,12,235,67,19431
431,431,15000US060816139002,324,92,0,12,0,12,0,12,324,92,41,41,283,85,19432
432,432,15000US060816139003,508,104,0,12,0,12,0,12,508,104,57,43,451,112,19433
433,433,15000US060816139004,217,54,0,12,0,12,0,12,217,54,76,51,141,54,19434
434,434,15000US060816139005,785,130,32,43,22,41,10,16,753,138,112,64,641,135,19435
435,435,15000US060816140001,930,85,19,21,0,12,19,21,911,86,112,39,799,92,19436
436,436,15000US060816140002,427,64,40,38,28,36,12,18,387,66,32,23,355,67,19437
437,437,15000US060816140003,308,59,0,12,0,12,0,12,308,59,114,63,194,51,19438
438,438,15000US060819843001,0,12,0,12,0,12,0,12,0,12,0,12,0,12,19439
439,439,15000US060819901000,0,12,0,12,0,12,0,12,0,12,0,12,0,12,19440
440,440,15000US060830001011,1189,168,89,93,0,12,89,93,1100,159,302,107,798,168,19441
441,441,15000US060830001012,420,95,14,21,14,21,0,12,406,99,99,60,307,91,19442
442,442,15000US060830001013,437,126,0,12,0,12,0,12,437,126,103,76,334,133,19443
443,443,15000US060830001014,315,124,0,12,0,12,0,12,315,124,89,92,226,111,19444
444,444,15000US060830001021,628,92,16,26,16,26,0,12,612,90,103,62,509,97,19445
445,445,15000US060830001022,192,66,26,31,12,21,14,22,166,60,0,12,166,60,19446
446,446,15000US060830001023,556,122,0,12,0,12,0,12,556,122,75,65,481,110,19447
447,447,15000US060830001024,744,133,0,12,0,12,0,12,744,133,214,120,530,135,19448
448,448,15000US060830001031,295,50,0,12,0,12,0,12,295,50,67,39,228,48,19449
449,449,15000US060830001032,588,95,8,13,0,12,8,13,580,98,63,34,517,95,19450
450,450,15000US060830001033,293,54,0,12,0,12,0,12,293,54,86,35,207,56,19451
451,451,15000US060830002001,498,145,0,12,0,12,0,12,498,145,137,91,361,127,19452
452,452,15000US060830002002,509,111,0,12,0,12,0,12,509,111,154,76,355,106,19453
453,453,15000US060830002003,1029,153,0,12,0,12,0,12,1029,153,195,98,834,152,19454
454,454,15000US060830003011,373,74,17,26,0,12,17,26,356,69,29,27,327,79,19455
455,455,15000US060830003012,461,87,0,12,0,12,0,12,461,87,109,55,352,84,19456
456,456,15000US060830003013,439,92,52,45,7,10,45,45,387,83,39,27,348,86,19457
457,457,15000US060830003021,249,67,0,12,0,12,0,12,249,67,7,12,242,68,19458
458,458,15000US060830003022,347,90,35,49,6,10,29,48,312,85,26,24,286,88,19459
459,459,15000US060830003023,535,105,9,14,0,12,9,14,526,105,84,36,442,109,19460
460,460,15000US060830003024,348,82,10,15,0,12,10,15,338,85,38,43,300,84,19461
461,461,15000US060830003025,331,97,0,12,0,12,0,12,331,97,116,63,215,92,19462
462,462,15000US060830004001,452,96,0,12,0,12,0,12,452,96,147,74,305,96,19463
463,463,15000US060830004002,345,97,0,12,0,12,0,12,345,97,77,54,268,102,19464
464,464,15000US060830004003,542,122,0,12,0,12,0,12,542,122,61,52,481,111,19465
465,465,15000US060830004004,388,79,0,12,0,12,0,12,388,79,26,31,362,85,19466
466,466,15000US060830004005,734,136,0,12,0,12,0,12,734,136,42,40,692,136,19467
467,467,15000US060830005011,390,48,0,12,0,12,0,12,390,48,56,33,334,54,19468
468,468,15000US060830005012,546,90,0,12,0,12,0,12,546,90,79,67,467,76,19469
469,469,15000US060830005013,428,60,0,12,0,12,0,12,428,60,43,29,385,63,19470
470,470,15000US060830005021,306,72,0,12,0,12,0,12,306,72,57,41,249,79,19471
471,471,15000US060830005022,385,80,21,35,0,12,21,35,364,78,32,38,332,76,19472
472,472,15000US060830005023,220,68,0,12,0,12,0,12,220,68,15,24,205,72,19473
473,473,15000US060830005024,406,91,0,12,0,12,0,12,406,91,49,44,357,102,19474
474,474,15000US060830005025,288,76,21,34,0,12,21,34,267,77,24,27,243,74,19475
475,475,15000US060830005026,859,112,36,58,0,12,36,58,823,111,122,70,701,117,19476
476,476,15000US060830006001,222,65,0,12,0,12,0,12,222,65,26,28,196,67,19477
477,477,15000US060830006002,510,128,0,12,0,12,0,12,510,128,67,46,443,138,19478
478,478,15000US060830006003,286,101,0,12,0,12,0,12,286,101,44,41,242,103,19479
479,479,15000US060830006004,400,105,0,12,0,12,0,12,400,105,36,40,364,106,19480
480,480,15000US060830006005,532,103,25,28,0,12,25,28,507,108,129,85,378,129,19481
481,481,15000US060830006006,248,71,0,12,0,12,0,12,248,71,15,24,233,70,19482
482,482,15000US060830007001,455,84,0,12,0,12,0,12,455,84,72,70,383,89,19483
483,483,15000US060830007002,422,70,6,10,6,10,0,12,416,69,58,34,358,68,19484
484,484,15000US060830007003,379,61,0,12,0,12,0,12,379,61,111,47,268,59,19485
485,485,15000US060830007004,807,100,18,27,0,12,18,27,789,97,157,85,632,98,19486
486,486,15000US060830008011,245,66,26,37,26,37,0,12,219,67,25,33,194,71,19487
487,487,15000US060830008012,473,85,26,31,0,12,26,31,447,82,132,54,315,88,19488
488,488,15000US060830008013,427,70,6,10,0,12,6,10,421,71,50,28,371,71,19489
489,489,15000US060830008041,379,113,0,12,0,12,0,12,379,113,45,40,334,106,19490
490,490,15000US060830008042,357,93,39,49,0,12,39,49,318,94,82,69,236,103,19491
491,491,15000US060830008043,426,127,27,37,0,12,27,37,399,123,45,41,354,124,19492
492,492,15000US060830008044,406,95,21,32,21,32,0,12,385,92,127,68,258,92,19493
493,493,15000US060830008045,378,92,88,66,7,13,81,64,290,96,67,45,223,89,19494
494,494,15000US060830009001,966,157,69,60,50,53,19,25,897,148,259,98,638,130,19495
495,495,15000US060830009002,715,135,0,12,0,12,0,12,715,135,160,83,555,136,19496
496,496,15000US060830010001,483,162,0,12,0,12,0,12,483,162,134,90,349,144,19497
497,497,15000US060830010002,378,114,0,12,0,12,0,12,378,114,49,47,329,115,19498
498,498,15000US060830010003,584,173,18,28,0,12,18,28,566,173,68,78,498,191,19499
499,499,15000US060830010004,740,158,0,12,0,12,0,12,740,158,218,112,522,145,19500
500,500,15000US060830010005,636,155,0,12,0,12,0,12,636,155,129,101,507,149,19501
501,501,15000US060830011011,652,118,117,86,43,54,74,66,535,127,127,77,408,124,19502
502,502,15000US060830011012,444,91,74,70,13,21,61,67,370,92,34,37,336,96,19503
503,503,15000US060830011013,251,85,89,73,24,36,65,65,162,63,0,12,162,63,19504
504,504,15000US060830011014,247,79,0,12,0,12,0,12,247,79,25,18,222,78,19505
505,505,15000US060830011021,479,84,68,63,0,12,68,63,411,81,87,49,324,70,19506
506,506,15000US060830011022,589,109,74,63,49,51,25,38,515,105,130,63,385,95,19507
507,507,15000US060830011023,249,73,55,49,55,49,0,12,194,57,104,54,90,53,19508
508,508,15000US060830012031,314,75,24,34,0,12,24,34,290,76,38,41,252,69,19509
509,509,15000US060830012032,917,79,47,48,20,21,27,43,870,90,180,67,690,89,19510
510,510,15000US060830012061,557,112,8,14,8,14,0,12,549,110,26,23,523,109,19511
511,511,15000US060830012062,528,101,21,36,0,12,21,36,507,96,66,47,441,99,19512
512,512,15000US060830012063,529,112,0,12,0,12,0,12,529,112,97,69,432,121,19513
513,513,15000US060830012081,444,104,0,12,0,12,0,12,444,104,110,68,334,98,19514
514,514,15000US060830012082,345,78,10,12,10,12,0,12,335,79,51,31,284,88,19515
515,515,15000US060830012083,279,57,0,12,0,12,0,12,279,57,91,53,188,52,19516
516,516,15000US060830012084,239,64,0,12,0,12,0,12,239,64,12,13,227,66,19517
517,517,15000US060830012085,338,70,15,20,0,12,15,20,323,70,50,40,273,69,19518
518,518,15000US060830013041,315,136,0,12,0,12,0,12,315,136,102,106,213,106,19519
519,519,15000US060830013042,293,87,0,12,0,12,0,12,293,87,99,71,194,74,19520
520,520,15000US060830013043,397,95,0,12,0,12,0,12,397,95,63,48,334,100,19521
521,521,15000US060830013044,404,139,0,12,0,12,0,12,404,139,13,20,391,139,19522
522,522,15000US060830013045,176,99,17,28,17,28,0,12,159,100,105,78,54,58,19523
523,523,15000US060830013046,289,84,42,58,0,12,42,58,247,81,61,44,186,95,19524
524,524,15000US060830013047,279,89,0,12,0,12,0,12,279,89,43,49,236,82,19525
525,525,15000US060830013048,337,94,46,70,0,12,46,70,291,98,36,43,255,99,19526
526,526,15000US060830013049,357,128,0,12,0,12,0,12,357,128,27,30,330,126,19527
527,527,15000US060830013061,557,66,12,18,0,12,12,18,545,68,84,44,461,65,19528
528,528,15000US060830013062,383,63,0,12,0,12,0,12,383,63,65,39,318,75,19529
529,529,15000US060830013063,560,68,42,45,8,12,34,44,518,76,200,67,318,65,19530
530,530,15000US060830014021,430,110,0,12,0,12,0,12,430,110,100,59,330,112,19531
531,531,15000US060830014022,390,79,9,13,9,13,0,12,381,79,96,38,285,79,19532
532,532,15000US060830014023,308,78,0,12,0,12,0,12,308,78,47,31,261,73,19533
533,533,15000US060830014024,242,80,32,50,0,12,32,50,210,71,59,31,151,67,19534
534,534,15000US060830015001,458,97,0,12,0,12,0,12,458,97,72,40,386,103,19535
535,535,15000US060830015002,348,63,0,12,0,12,0,12,348,63,47,26,301,65,19536
536,536,15000US060830015003,445,76,9,16,9,16,0,12,436,75,29,25,407,75,19537
537,537,15000US060830016011,346,72,8,14,0,12,8,14,338,74,124,66,214,66,19538
538,538,15000US060830016012,822,107,16,19,10,15,6,12,806,106,163,65,643,114,19539
539,539,15000US060830016013,678,98,22,30,22,30,0,12,656,103,142,58,514,105,19540
540,540,15000US060830016041,454,159,0,12,0,12,0,12,454,159,79,65,375,141,19541
541,541,15000US060830016042,341,106,34,38,18,27,16,26,307,103,70,82,237,98,19542
542,542,15000US060830016043,419,146,0,12,0,12,0,12,419,146,128,127,291,138,19543
543,543,15000US060830016044,862,139,80,81,58,74,22,38,782,144,152,97,630,135,19544
544,544,15000US060830017041,617,67,12,14,6,10,6,10,605,64,138,54,467,66,19545
545,545,15000US060830017042,474,65,23,19,12,13,11,14,451,68,72,39,379,64,19546
546,546,15000US060830017061,567,112,0,12,0,12,0,12,567,112,93,45,474,114,19547
547,547,15000US060830017062,459,85,0,12,0,12,0,12,459,85,145,54,314,76,19548
548,548,15000US060830017063,249,68,0,12,0,12,0,12,249,68,14,17,235,66,19549
549,549,15000US060830017064,247,88,0,12,0,12,0,12,247,88,13,17,234,88,19550
550,550,15000US060830017065,417,122,0,12,0,12,0,12,417,122,34,43,383,124,19551
551,551,15000US060830018001,380,46,15,17,5,7,10,15,365,46,96,32,269,47,19552
552,552,15000US060830019011,488,122,48,72,0,12,48,72,440,129,124,75,316,118,19553
553,553,15000US060830019012,229,87,0,12,0,12,0,12,229,87,95,64,134,70,19554
554,554,15000US060830019013,910,169,31,54,0,12,31,54,879,157,46,58,833,156,19555
555,555,15000US060830019014,801,130,35,55,35,55,0,12,766,128,237,120,529,128,19556
556,556,15000US060830019015,200,83,0,12,0,12,0,12,200,83,68,68,132,60,19557
557,557,15000US060830019031,345,78,3,5,0,12,3,5,342,77,85,37,257,74,19558
558,558,15000US060830019032,476,114,0,12,0,12,0,12,476,114,106,64,370,131,19559
559,559,15000US060830019033,412,112,0,12,0,12,0,12,412,112,55,46,357,115,19560
560,560,15000US060830019034,920,177,12,19,12,19,0,12,908,177,291,131,617,157,19561
561,561,15000US060830019035,499,120,11,19,11,19,0,12,488,124,77,51,411,124,19562
562,562,15000US060830019051,445,81,4,7,0,12,4,7,441,81,108,51,333,73,19563
563,563,15000US060830019052,255,66,3,4,0,12,3,4,252,66,45,29,207,61,19564
564,564,15000US060830019053,324,57,7,10,0,12,7,10,317,56,50,28,267,58,19565
565,565,15000US060830019061,552,119,0,12,0,12,0,12,552,119,57,46,495,122,19566
566,566,15000US060830019062,475,102,0,12,0,12,0,12,475,102,45,38,430,105,19567
567,567,15000US060830019063,347,73,0,12,0,12,0,12,347,73,79,50,268,62,19568
568,568,15000US060830019064,340,120,0,12,0,12,0,12,340,120,124,93,216,100,19569
569,569,15000US060830019065,555,105,11,12,1,5,10,11,544,103,183,81,361,115,19570
570,570,15000US060830020051,201,46,24,38,0,12,24,38,177,44,52,34,125,46,19571
571,571,15000US060830020052,469,77,22,26,0,12,22,26,447,77,97,53,350,73,19572
572,572,15000US060830020053,682,78,90,71,40,43,50,58,592,76,163,60,429,81,19573
573,573,15000US060830020054,543,79,0,12,0,12,0,12,543,79,113,47,430,85,19574
574,574,15000US060830020061,498,55,9,9,2,3,7,9,489,56,95,32,394,56,19575
575,575,15000US060830020062,314,51,22,24,16,22,6,9,292,52,58,22,234,50,19576
576,576,15000US060830020071,344,82,0,12,0,12,0,12,344,82,56,54,288,87,19577
577,577,15000US060830020072,294,104,0,12,0,12,0,12,294,104,46,41,248,109,19578
578,578,15000US060830020073,384,82,13,22,13,22,0,12,371,85,111,69,260,86,19579
579,579,15000US060830020074,975,154,26,31,0,12,26,31,949,158,267,109,682,157,19580
580,580,15000US060830020075,496,155,65,83,18,29,47,77,431,147,269,125,162,114,19581
581,581,15000US060830020076,453,115,0,12,0,12,0,12,453,115,30,34,423,119,19582
582,582,15000US060830020077,771,141,14,22,14,22,0,12,757,145,123,63,634,151,19583
583,583,15000US060830020081,897,149,0,12,0,12,0,12,897,149,199,96,698,169,19584
584,584,15000US060830020082,211,60,15,24,15,24,0,12,196,58,12,19,184,60,19585
585,585,15000US060830020083,317,82,0,12,0,12,0,12,317,82,105,68,212,79,19586
586,586,15000US060830020084,477,102,49,45,0,12,49,45,428,106,82,64,346,100,19587
587,587,15000US060830020085,289,81,29,35,0,12,29,35,260,88,163,82,97,55,19588
588,588,15000US060830020091,484,79,0,12,0,12,0,12,484,79,175,68,309,86,19589
589,589,15000US060830020092,354,99,8,14,0,12,8,14,346,100,133,64,213,93,19590
590,590,15000US060830020093,534,112,59,54,34,40,25,36,475,102,112,60,363,102,19591
591,591,15000US060830020101,734,79,21,32,21,32,0,12,713,84,118,52,595,89,19592
592,592,15000US060830020102,371,69,6,9,0,12,6,9,365,70,142,61,223,84,19593
593,593,15000US060830020103,211,50,14,13,14,13,0,12,197,52,64,31,133,57,19594
594,594,15000US060830020104,209,54,9,17,0,12,9,17,200,54,42,27,158,62,19595
595,595,15000US060830020111,923,93,22,32,0,12,22,32,901,86,104,45,797,94,19596
596,596,15000US060830020112,243,61,10,15,0,12,10,15,233,58,70,36,163,63,19597
597,597,15000US060830020113,535,83,206,94,111,79,95,56,329,77,111,60,218,70,19598
598,598,15000US060830020121,460,53,0,12,0,12,0,12,460,53,57,36,403,65,19599
599,599,15000US060830020122,378,71,25,30,25,30,0,12,353,70,49,39,304,76,19600
600,600,15000US060830020123,379,70,32,29,13,20,19,21,347,69,67,58,280,69,19601
601,601,15000US060830020131,466,74,0,12,0,12,0,12,466,74,143,53,323,67,19602
602,602,15000US060830020132,514,68,0,12,0,12,0,12,514,68,87,41,427,74,19603
603,603,15000US060830021011,560,101,156,72,82,63,74,52,404,91,87,47,317,82,19604
604,604,15000US060830021012,632,113,179,102,80,77,99,81,453,117,82,69,371,107,19605
605,605,15000US060830021021,503,59,21,20,13,19,8,10,482,61,57,30,425,62,19606
606,606,15000US060830021022,263,49,20,16,11,13,9,9,243,49,79,40,164,48,19607
607,607,15000US060830021031,489,110,92,39,29,28,63,35,397,110,49,28,348,107,19608
608,608,15000US060830021032,670,117,132,82,0,12,132,82,538,110,168,77,370,107,19609
609,609,15000US060830021033,339,65,8,13,8,13,0,12,331,67,76,35,255,64,19610
610,610,15000US060830022051,387,71,90,51,39,37,51,36,297,67,59,27,238,69,19611
611,611,15000US060830022052,385,87,85,55,34,35,51,45,300,75,131,55,169,58,19612
612,612,15000US060830022053,612,115,104,57,22,23,82,52,508,118,103,65,405,107,19613
613,613,15000US060830022061,467,92,51,55,0,12,51,55,416,89,145,63,271,91,19614
614,614,15000US060830022062,619,98,125,63,54,42,71,57,494,94,175,70,319,103,19615
615,615,15000US060830022063,400,74,95,57,0,12,95,57,305,85,124,55,181,76,19616
616,616,15000US060830022091,520,77,106,50,65,42,41,30,414,86,125,52,289,88,19617
617,617,15000US060830022092,365,65,80,43,13,15,67,43,285,74,103,48,182,67,19618
618,618,15000US060830022101,756,108,38,38,29,35,9,16,718,107,160,58,558,100,19619
619,619,15000US060830022102,500,94,45,40,0,12,45,40,455,93,122,68,333,95,19620
620,620,15000US060830022103,307,84,0,12,0,12,0,12,307,84,28,21,279,88,19621
621,621,15000US060830022111,518,106,0,12,0,12,0,12,518,106,317,109,201,82,19622
622,622,15000US060830022112,491,106,31,41,31,41,0,12,460,106,140,69,320,92,19623
623,623,15000US060830022113,721,155,44,69,0,12,44,69,677,152,186,117,491,144,19624
624,624,15000US060830022114,326,97,32,37,32,37,0,12,294,97,53,48,241,102,19625
625,625,15000US060830023031,299,79,75,55,52,44,23,35,224,77,40,32,184,71,19626
626,626,15000US060830023032,301,71,13,21,0,12,13,21,288,73,60,36,228,78,19627
627,627,15000US060830023033,362,83,103,60,36,32,67,56,259,82,63,41,196,82,19628
628,628,15000US060830023034,289,81,44,31,12,18,32,27,245,83,99,66,146,75,19629
629,629,15000US060830023035,135,51,6,11,0,12,6,11,129,52,69,42,60,40,19630
630,630,15000US060830023041,251,78,79,52,19,29,60,44,172,70,26,21,146,68,19631
631,631,15000US060830023042,307,62,44,32,7,11,37,31,263,67,47,33,216,68,19632
632,632,15000US060830023043,367,83,84,48,18,20,66,46,283,72,47,35,236,76,19633
633,633,15000US060830023044,428,87,118,67,0,12,118,67,310,81,83,52,227,80,19634
634,634,15000US060830023051,351,81,115,77,28,30,87,72,236,65,115,45,121,57,19635
635,635,15000US060830023052,309,94,17,18,10,16,7,11,292,94,94,41,198,84,19636
636,636,15000US060830023053,355,81,53,33,33,25,20,21,302,77,51,34,251,80,19637
637,637,15000US060830023054,523,92,131,61,100,62,31,40,392,78,61,34,331,77,19638
638,638,15000US060830023061,225,117,0,12,0,12,0,12,225,117,0,12,225,117,19639
639,639,15000US060830023062,434,122,14,22,0,12,14,22,420,121,98,67,322,127,19640
640,640,15000US060830023063,655,134,28,31,28,31,0,12,627,136,418,119,209,113,19641
641,641,15000US060830023064,1126,193,107,73,51,46,56,68,1019,202,206,126,813,195,19642
642,642,15000US060830024021,316,73,28,32,13,22,15,22,288,70,118,63,170,69,19643
643,643,15000US060830024022,1949,180,337,122,51,58,286,126,1612,203,261,92,1351,196,19644
644,644,15000US060830024023,306,96,168,86,28,26,140,95,138,78,27,41,111,67,19645
645,645,15000US060830024024,659,131,100,91,31,43,69,77,559,152,107,61,452,145,19646
646,646,15000US060830024031,525,86,93,58,0,12,93,58,432,93,98,50,334,94,19647
647,647,15000US060830024032,442,82,171,68,57,38,114,66,271,80,91,52,180,72,19648
648,648,15000US060830024033,557,87,192,85,81,62,111,54,365,92,69,52,296,80,19649
649,649,15000US060830024041,507,87,109,58,16,26,93,53,398,74,33,38,365,66,19650
650,650,15000US060830024042,575,109,95,58,44,36,51,47,480,117,13,15,467,115,19651
651,651,15000US060830024043,186,69,81,53,38,32,43,47,105,52,42,29,63,48,19652
652,652,15000US060830024044,496,102,122,62,2,6,120,62,374,103,64,43,310,109,19653
653,653,15000US060830025021,286,70,49,45,45,44,4,8,237,71,105,56,132,70,19654
654,654,15000US060830025022,852,112,110,66,39,33,71,56,742,113,214,72,528,113,19655
655,655,15000US060830025023,390,81,119,73,42,43,77,63,271,94,49,30,222,96,19656
656,656,15000US060830025024,486,102,86,59,8,13,78,58,400,104,78,56,322,99,19657
657,657,15000US060830026041,33,14,0,12,0,12,0,12,33,14,4,7,29,12,19658
658,658,15000US060830026061,943,80,0,12,0,12,0,12,943,80,81,37,862,76,19659
659,659,15000US060830027021,242,89,142,84,0,12,142,84,100,58,17,24,83,52,19660
660,660,15000US060830027022,366,133,155,106,40,51,115,104,211,94,60,58,151,87,19661
661,661,15000US060830027023,619,146,168,111,14,22,154,114,451,144,132,76,319,135,19662
662,662,15000US060830027024,742,159,240,108,53,49,187,109,502,149,154,112,348,122,19663
663,663,15000US060830027025,396,131,100,80,0,12,100,80,296,122,62,68,234,117,19664
664,664,15000US060830027031,627,79,89,61,84,63,5,8,538,83,144,87,394,82,19665
665,665,15000US060830027032,840,125,164,102,98,95,66,42,676,136,211,96,465,125,19666
666,666,15000US060830027051,561,107,36,39,0,12,36,39,525,107,144,73,381,93,19667
667,667,15000US060830027052,721,103,246,88,68,58,178,81,475,96,212,63,263,91,19668
668,668,15000US060830027053,247,63,15,18,8,12,7,14,232,64,117,45,115,59,19669
669,669,15000US060830027061,395,90,17,20,8,12,9,17,378,91,122,55,256,84,19670
670,670,15000US060830027062,428,92,68,51,40,41,28,35,360,96,67,40,293,95,19671
671,671,15000US060830027063,643,117,123,76,20,24,103,76,520,116,116,61,404,116,19672
672,672,15000US060830027064,271,70,50,45,10,16,40,43,221,63,103,53,118,56,19673
673,673,15000US060830027065,216,84,154,70,19,22,135,72,62,48,17,23,45,40,19674
674,674,15000US060830027071,280,51,20,16,0,12,20,16,260,50,78,35,182,49,19675
675,675,15000US060830027072,257,58,42,33,34,32,8,8,215,51,29,30,186,48,19676
676,676,15000US060830027073,431,65,29,26,25,25,4,7,402,66,99,38,303,59,19677
677,677,15000US060830027081,310,70,16,18,5,7,11,17,294,71,21,24,273,67,19678
678,678,15000US060830027082,441,78,62,59,0,12,62,59,379,74,101,46,278,68,19679
679,679,15000US060830027083,371,73,22,22,7,13,15,18,349,76,68,41,281,82,19680
680,680,15000US060830028021,594,115,147,105,40,53,107,100,447,120,85,52,362,121,19681
681,681,15000US060830028022,335,117,67,95,0,12,67,95,268,71,103,54,165,65,19682
682,682,15000US060830028023,1009,196,43,50,14,23,29,45,966,195,273,160,693,170,19683
683,683,15000US060830028024,520,132,0,12,0,12,0,12,520,132,180,90,340,123,19684
684,684,15000US060830028061,500,56,17,15,12,13,5,8,483,55,123,48,360,63,19685
685,685,15000US060830028062,308,46,51,37,20,29,31,23,257,47,127,46,130,53,19686
686,686,15000US060830028081,223,80,0,12,0,12,0,12,223,80,79,60,144,70,19687
687,687,15000US060830028082,213,95,0,12,0,12,0,12,213,95,86,59,127,91,19688
688,688,15000US060830028083,499,127,0,12,0,12,0,12,499,127,128,63,371,128,19689
689,689,15000US060830028084,516,121,22,35,0,12,22,35,494,114,236,105,258,85,19690
690,690,15000US060830028085,330,99,17,28,0,12,17,28,313,99,166,96,147,65,19691
691,691,15000US060830028086,792,136,47,48,10,17,37,43,745,137,141,84,604,147,19692
692,692,15000US060830028091,268,55,9,15,0,12,9,15,259,54,102,47,157,56,19693
693,693,15000US060830028092,398,80,7,10,0,12,7,10,391,80,68,41,323,82,19694
694,694,15000US060830028093,294,70,9,14,9,14,0,12,285,70,58,34,227,70,19695
695,695,15000US060830028094,589,74,17,19,9,15,8,13,572,75,85,44,487,84,19696
696,696,15000US060830029061,315,45,0,12,0,12,0,12,315,45,86,37,229,50,19697
697,697,15000US060830029062,530,87,0,12,0,12,0,12,530,87,133,63,397,92,19698
698,698,15000US060830029063,528,66,10,15,10,15,0,12,518,66,95,37,423,67,19699
699,699,15000US060830029071,669,77,8,13,8,13,0,12,661,80,121,51,540,88,19700
700,700,15000US060830029072,444,67,9,14,0,12,9,14,435,68,52,33,383,73,19701
701,701,15000US060830029073,420,82,0,12,0,12,0,12,420,82,63,35,357,90,19702
702,702,15000US060830029091,612,88,16,25,0,12,16,25,596,90,156,62,440,88,19703
703,703,15000US060830029092,603,99,9,13,0,12,9,13,594,103,108,63,486,114,19704
704,704,15000US060830029093,509,68,9,14,9,14,0,12,500,70,97,44,403,78,19705
705,705,15000US060830029131,597,88,12,17,0,12,12,17,585,88,91,58,494,76,19706
706,706,15000US060830029132,913,107,52,59,52,59,0,12,861,104,308,71,553,101,19707
707,707,15000US060830029141,369,77,0,12,0,12,0,12,369,77,172,65,197,68,19708
708,708,15000US060830029142,415,71,42,54,0,12,42,54,373,60,53,26,320,64,19709
709,709,15000US060830029143,470,66,0,12,0,12,0,12,470,66,113,51,357,66,19710
710,710,15000US060830029151,236,33,16,14,0,12,16,14,220,35,25,19,195,38,19711
711,711,15000US060830029221,9,9,0,17,0,17,0,17,9,9,0,17,9,9,19712
712,712,15000US060830029222,0,12,0,12,0,12,0,12,0,12,0,12,0,12,19713
713,713,15000US060830029223,0,12,0,12,0,12,0,12,0,12,0,12,0,12,19714
714,714,15000US060830029224,466,56,3,4,3,4,0,12,463,55,56,28,407,60,19715
715,715,15000US060830029225,318,54,23,18,0,12,23,18,295,54,18,16,277,55,19716
716,716,15000US060830029241,461,110,33,33,0,12,33,33,428,112,13,20,415,116,19717
717,717,15000US060830029242,479,110,29,35,0,12,29,35,450,107,7,11,443,107,19718
718,718,15000US060830029243,177,68,0,12,0,12,0,12,177,68,35,42,142,58,19719
719,719,15000US060830029244,379,91,26,42,0,12,26,42,353,88,19,18,334,89,19720
720,720,15000US060830029261,663,91,56,32,9,11,47,31,607,91,51,32,556,88,19721
721,721,15000US060830029262,336,71,0,12,0,12,0,12,336,71,24,37,312,67,19722
722,722,15000US060830029263,771,94,95,46,24,23,71,43,676,88,199,61,477,96,19723
723,723,15000US060830029281,697,120,27,26,0,12,27,26,670,124,83,58,587,131,19724
724,724,15000US060830029282,675,142,16,20,0,12,16,20,659,140,78,86,581,122,19725
725,725,15000US060830029301,735,153,0,12,0,12,0,12,735,153,155,84,580,146,19726
726,726,15000US060830029302,345,84,0,12,0,12,0,12,345,84,68,83,277,78,19727
727,727,15000US060830029303,361,102,32,39,13,22,19,32,329,95,31,37,298,93,19728
728,728,15000US060830029304,347,112,0,12,0,12,0,12,347,112,36,41,311,116,19729
729,729,15000US060830029305,583,137,17,26,0,12,17,26,566,141,28,34,538,150,19730
730,730,15000US060830029306,571,123,52,60,16,26,36,55,519,129,46,44,473,128,19731
731,731,15000US060830029321,176,48,2,3,0,12,2,3,174,48,10,9,164,48,19732
732,732,15000US060830029322,553,60,11,13,0,12,11,13,542,59,67,25,475,60,19733
733,733,15000US060830030011,269,75,0,12,0,12,0,12,269,75,65,52,204,74,19734
734,734,15000US060830030012,727,121,25,40,0,12,25,40,702,115,111,59,591,117,19735
735,735,15000US060830030013,492,119,0,12,0,12,0,12,492,119,42,39,450,131,19736
736,736,15000US060830030014,493,112,134,98,37,60,97,79,359,111,76,60,283,106,19737
737,737,15000US060830030015,251,106,37,49,0,12,37,49,214,105,29,33,185,96,19738
738,738,15000US060830030041,474,63,0,12,0,12,0,12,474,63,65,40,409,67,19739
739,739,15000US060830030042,639,78,0,12,0,12,0,12,639,78,142,50,497,78,19740
740,740,15000US060830030043,504,64,5,10,5,10,0,12,499,66,92,49,407,81,19741
741,741,15000US060830030051,310,73,8,13,8,13,0,12,302,74,57,34,245,76,19742
742,742,15000US060830030052,586,82,0,12,0,12,0,12,586,82,212,76,374,80,19743
743,743,15000US060830030053,596,61,43,41,26,35,17,19,553,70,82,58,471,69,19744
744,744,15000US060830030071,461,74,0,12,0,12,0,12,461,74,68,32,393,70,19745
745,745,15000US060830030072,381,65,11,14,11,14,0,12,370,67,60,28,310,73,19746
746,746,15000US060830030073,553,94,7,10,0,12,7,10,546,93,148,52,398,93,19747
747,747,15000US060830031021,269,66,0,12,0,12,0,12,269,66,99,44,170,62,19748
748,748,15000US060830031022,418,77,34,27,9,15,25,23,384,82,106,55,278,88,19749
749,749,15000US060830031023,442,64,18,19,0,12,18,19,424,68,102,55,322,73,19750
750,750,15000US060839800001,4,7,0,12,0,12,0,12,4,7,0,12,4,7,19751
751,751,15000US060839801001,0,12,0,12,0,12,0,12,0,12,0,12,0,12,19752
752,752,15000US060839900000,0,12,0,12,0,12,0,12,0,12,0,12,0,12,19753
753,753,15000US060855001001,286,118,48,79,0,12,48,79,238,82,31,25,207,88,19754
754,754,15000US060855001002,664,133,55,49,21,32,34,37,609,141,65,47,544,142,19755
755,755,15000US060855001003,561,166,118,78,0,12,118,78,443,169,120,95,323,162,19756
756,756,15000US060855001004,884,160,154,108,34,38,120,102,730,147,58,41,672,153,19757
757,757,15000US060855002001,526,102,16,27,16,27,0,12,510,106,30,36,480,105,19758
758,758,15000US060855002002,0,12,0,12,0,12,0,12,0,12,0,12,0,12,19759
759,759,15000US060855002003,615,120,29,45,29,45,0,12,586,121,63,49,523,131,19760
760,760,15000US060855002004,1004,147,16,27,16,27,0,12,988,143,59,48,929,140,19761
761,761,15000US060855003001,142,62,0,12,0,12,0,12,142,62,11,17,131,61,19762
762,762,15000US060855003002,1322,80,70,51,8,12,62,45,1252,91,111,69,1141,113,19763
763,763,15000US060855004001,593,55,51,38,0,12,51,38,542,58,121,51,421,66,19764
764,764,15000US060855004002,404,46,5,7,5,7,0,12,399,47,41,21,358,52,19765
765,765,15000US060855005001,455,82,0,12,0,12,0,12,455,82,99,71,356,73,19766
766,766,15000US060855005002,674,102,34,38,21,29,13,21,640,115,83,47,557,112,19767
767,767,15000US060855005003,249,84,19,29,0,12,19,29,230,79,24,24,206,79,19768
768,768,15000US060855005004,408,84,22,25,15,22,7,10,386,88,96,48,290,100,19769
769,769,15000US060855005005,265,57,18,20,0,12,18,20,247,59,66,37,181,59,19770
770,770,15000US060855006001,1494,126,74,49,9,17,65,44,1420,139,210,95,1210,150,19771
771,771,15000US060855006002,471,97,0,12,0,12,0,12,471,97,62,61,409,110,19772
772,772,15000US060855006003,399,92,13,22,13,22,0,12,386,96,21,24,365,94,19773
773,773,15000US060855008001,847,110,24,22,15,19,9,12,823,111,167,72,656,104,19774
774,774,15000US060855008002,917,112,60,45,9,14,51,45,857,114,129,70,728,129,19775
775,775,15000US060855009011,386,92,41,44,7,14,34,42,345,88,29,31,316,84,19776
776,776,15000US060855009012,1677,133,155,96,9,12,146,96,1522,135,121,55,1401,138,19777
777,777,15000US060855009021,354,45,39,26,11,12,28,23,315,43,24,20,291,42,19778
778,778,15000US060855009022,256,46,57,32,0,17,57,32,199,42,14,11,185,40,19779
779,779,15000US060855010001,425,130,112,94,20,39,92,83,313,122,59,65,254,105,19780
780,780,15000US060855010002,358,122,15,24,15,24,0,12,343,119,56,65,287,110,19781
781,781,15000US060855010003,433,105,28,32,13,21,15,24,405,105,164,72,241,101,19782
782,782,15000US060855010004,489,128,45,66,0,12,45,66,444,136,154,85,290,126,19783
783,783,15000US060855010005,292,96,19,31,19,31,0,12,273,99,0,12,273,99,19784
784,784,15000US060855011011,1040,112,58,39,56,40,2,8,982,120,139,73,843,119,19785
785,785,15000US060855011012,904,108,36,27,8,13,28,25,868,111,143,72,725,109,19786
786,786,15000US060855011021,385,81,6,10,6,10,0,12,379,82,121,42,258,84,19787
787,787,15000US060855011022,524,83,69,56,10,15,59,55,455,90,107,66,348,97,19788
788,788,15000US060855011023,470,78,16,23,0,12,16,23,454,77,90,64,364,78,19789
789,789,15000US060855012001,251,75,8,13,0,12,8,13,243,74,64,47,179,70,19790
790,790,15000US060855012002,426,100,89,68,82,68,7,11,337,84,69,48,268,87,19791
791,791,15000US060855012003,400,97,29,42,0,12,29,42,371,91,105,50,266,84,19792
792,792,15000US060855012004,296,86,52,31,38,28,14,17,244,81,43,31,201,79,19793
793,793,15000US060855013001,177,36,7,12,7,12,0,12,170,35,31,26,139,39,19794
794,794,15000US060855013002,197,49,0,12,0,12,0,12,197,49,25,23,172,53,19795
795,795,15000US060855013003,536,90,57,45,0,12,57,45,479,93,71,60,408,94,19796
796,796,15000US060855013004,228,53,31,26,31,26,0,12,197,54,16,18,181,56,19797
797,797,15000US060855014011,806,57,155,69,25,25,130,63,651,83,122,46,529,76,19798
798,798,15000US060855014012,231,50,49,35,33,29,16,20,182,46,60,30,122,45,19799
799,799,15000US060855014021,426,55,57,33,0,12,57,33,369,60,64,34,305,62,19800
800,800,15000US060855014022,491,62,131,49,10,12,121,49,360,61,77,38,283,59,19801
801,801,15000US060855015011,662,92,60,45,14,16,46,42,602,91,135,65,467,98,19802
802,802,15000US060855015012,660,86,127,74,41,48,86,57,533,100,130,71,403,100,19803
803,803,15000US060855015021,502,85,44,49,0,12,44,49,458,92,102,61,356,85,19804
804,804,15000US060855015022,679,88,106,66,18,18,88,62,573,101,135,67,438,96,19805
805,805,15000US060855016001,193,97,0,12,0,12,0,12,193,97,39,49,154,91,19806
806,806,15000US060855016002,401,144,15,25,15,25,0,12,386,141,17,28,369,140,19807
807,807,15000US060855016003,666,154,59,74,43,70,16,26,607,148,47,44,560,156,19808
808,808,15000US060855016004,800,161,72,82,36,59,36,58,728,153,10,17,718,155,19809
809,809,15000US060855016005,435,124,34,49,34,49,0,12,401,128,52,43,349,137,19810
810,810,15000US060855017001,220,58,23,25,0,12,23,25,197,59,45,34,152,60,19811
811,811,15000US060855017002,180,74,47,37,26,40,21,23,133,71,12,16,121,68,19812
812,812,15000US060855017003,584,105,144,80,39,43,105,72,440,107,83,59,357,103,19813
813,813,15000US060855017004,360,79,93,72,0,12,93,72,267,65,97,56,170,54,19814
814,814,15000US060855018001,434,86,53,35,18,23,35,37,381,88,57,52,324,78,19815
815,815,15000US060855018002,409,92,43,36,26,40,17,18,366,96,63,39,303,99,19816
816,816,15000US060855018003,434,92,33,30,20,22,13,19,401,89,108,68,293,78,19817
817,817,15000US060855018004,460,80,10,15,0,12,10,15,450,81,73,36,377,89,19818
818,818,15000US060855019001,1690,174,29,37,0,12,29,37,1661,174,237,102,1424,183,19819
819,819,15000US060855019002,947,157,57,70,17,30,40,64,890,157,93,81,797,174,19820
820,820,15000US060855020011,517,104,89,80,0,12,89,80,428,98,73,61,355,91,19821
821,821,15000US060855020012,408,86,17,19,7,11,10,15,391,87,48,32,343,89,19822
822,822,15000US060855020013,409,81,9,14,9,14,0,12,400,81,50,32,350,81,19823
823,823,15000US060855020014,779,117,72,65,17,19,55,61,707,117,121,63,586,113,19824
824,824,15000US060855020021,296,72,62,40,11,16,51,37,234,72,29,20,205,74,19825
825,825,15000US060855020022,509,103,124,63,45,43,79,49,385,111,102,68,283,96,19826
826,826,15000US060855020023,848,107,48,32,25,28,23,29,800,108,145,66,655,114,19827
827,827,15000US060855021011,501,77,0,12,0,12,0,12,501,77,110,45,391,77,19828
828,828,15000US060855021012,335,71,6,10,0,12,6,10,329,72,48,29,281,72,19829
829,829,15000US060855021013,1099,97,14,18,14,18,0,12,1085,101,167,55,918,115,19830
830,830,15000US060855021021,861,144,181,117,71,68,110,99,680,135,80,67,600,128,19831
831,831,15000US060855021022,824,167,113,101,81,98,32,33,711,168,151,62,560,169,19832
832,832,15000US060855021023,548,115,40,47,26,41,14,21,508,110,34,40,474,114,19833
833,833,15000US060855021024,460,119,0,12,0,12,0,12,460,119,51,49,409,124,19834
834,834,15000US060855022011,1691,186,102,66,49,50,53,48,1589,201,314,121,1275,196,19835
835,835,15000US060855022012,1341,203,138,70,86,75,52,50,1203,213,158,118,1045,227,19836
836,836,15000US060855022021,758,72,11,17,0,12,11,17,747,70,80,42,667,79,19837
837,837,15000US060855022022,342,64,8,12,8,12,0,12,334,65,16,19,318,69,19838
838,838,15000US060855022023,346,66,8,13,0,12,8,13,338,64,53,37,285,77,19839
839,839,15000US060855023011,646,73,8,12,0,12,8,12,638,76,60,45,578,77,19840
840,840,15000US060855023012,708,71,0,12,0,12,0,12,708,71,80,46,628,76,19841
841,841,15000US060855023021,605,69,33,31,10,15,23,26,572,70,34,22,538,72,19842
842,842,15000US060855023022,670,69,10,15,0,12,10,15,660,69,93,55,567,82,19843
843,843,15000US060855024001,230,51,0,12,0,12,0,12,230,51,11,17,219,49,19844
844,844,15000US060855024002,250,67,0,12,0,12,0,12,250,67,52,41,198,68,19845
845,845,15000US060855024003,246,66,0,12,0,12,0,12,246,66,0,12,246,66,19846
846,846,15000US060855024004,414,111,0,12,0,12,0,12,414,111,13,21,401,114,19847
847,847,15000US060855024005,758,127,40,59,0,12,40,59,718,123,169,71,549,124,19848
848,848,15000US060855024006,564,114,0,12,0,12,0,12,564,114,17,30,547,111,19849
849,849,15000US060855024007,313,85,19,30,19,30,0,12,294,89,28,31,266,87,19850
850,850,15000US060855025001,386,79,0,12,0,12,0,12,386,79,41,49,345,89,19851
851,851,15000US060855025002,452,82,13,22,13,22,0,12,439,80,69,47,370,91,19852
852,852,15000US060855025003,428,85,0,12,0,12,0,12,428,85,36,35,392,92,19853
853,853,15000US060855025004,405,62,0,12,0,12,0,12,405,62,29,32,376,71,19854
854,854,15000US060855025005,309,85,17,24,17,24,0,12,292,82,19,28,273,85,19855
855,855,15000US060855025006,481,73,0,12,0,12,0,12,481,73,135,60,346,87,19856
856,856,15000US060855026011,256,56,0,12,0,12,0,12,256,56,12,18,244,57,19857
857,857,15000US060855026012,328,52,0,12,0,12,0,12,328,52,54,34,274,59,19858
858,858,15000US060855026013,623,70,0,12,0,12,0,12,623,70,252,87,371,84,19859
859,859,15000US060855026031,302,56,7,11,7,11,0,12,295,56,47,30,248,57,19860
860,860,15000US060855026032,295,48,0,12,0,12,0,12,295,48,44,26,251,52,19861
861,861,15000US060855026033,379,57,10,15,10,15,0,12,369,58,39,27,330,62,19862
862,862,15000US060855026041,918,152,0,12,0,12,0,12,918,152,127,95,791,138,19863
863,863,15000US060855026042,667,157,17,31,0,12,17,31,650,160,57,75,593,162,19864
864,864,15000US060855026043,405,124,8,22,8,22,0,12,397,120,127,76,270,115,19865
865,865,15000US060855027011,708,88,26,22,26,22,0,12,682,88,176,70,506,92,19866
866,866,15000US060855027012,568,81,19,21,3,9,16,20,549,81,79,39,470,82,19867
867,867,15000US060855027013,696,103,84,65,10,17,74,63,612,105,128,72,484,99,19868
868,868,15000US060855027021,961,121,0,12,0,12,0,12,961,121,197,77,764,127,19869
869,869,15000US060855027022,674,107,38,39,0,12,38,39,636,105,132,73,504,114,19870
870,870,15000US060855027023,350,81,0,12,0,12,0,12,350,81,53,49,297,84,19871
871,871,15000US060855027024,578,80,0,12,0,12,0,12,578,80,82,53,496,102,19872
872,872,15000US060855027025,421,86,0,12,0,12,0,12,421,86,72,38,349,83,19873
873,873,15000US060855028001,499,71,0,12,0,12,0,12,499,71,158,63,341,87,19874
874,874,15000US060855028002,606,76,19,21,0,12,19,21,587,78,122,66,465,86,19875
875,875,15000US060855028003,339,55,4,9,4,9,0,12,335,56,79,44,256,64,19876
876,876,15000US060855029011,538,96,95,84,48,76,47,54,443,110,96,52,347,113,19877
877,877,15000US060855029012,515,112,9,15,9,15,0,12,506,115,46,47,460,123,19878
878,878,15000US060855029013,398,81,0,12,0,12,0,12,398,81,101,73,297,101,19879
879,879,15000US060855029014,780,127,39,39,24,30,15,24,741,135,75,46,666,132,19880
880,880,15000US060855029021,873,114,0,12,0,12,0,12,873,114,208,79,665,127,19881
881,881,15000US060855029022,896,130,0,12,0,12,0,12,896,130,172,94,724,145,19882
882,882,15000US060855029023,938,124,0,12,0,12,0,12,938,124,216,95,722,137,19883
883,883,15000US060855029031,815,79,8,13,8,13,0,12,807,81,220,74,587,87,19884
884,884,15000US060855029032,519,62,0,12,0,12,0,12,519,62,121,55,398,69,19885
885,885,15000US060855029033,590,66,13,15,0,12,13,15,577,68,80,38,497,73,19886
886,886,15000US060855029061,488,86,70,58,0,12,70,58,418,90,47,33,371,91,19887
887,887,15000US060855029062,586,73,13,21,12,20,1,7,573,74,165,48,408,72,19888
888,888,15000US060855029063,465,80,35,42,0,12,35,42,430,73,114,66,316,77,19889
889,889,15000US060855029071,743,66,9,14,9,14,0,12,734,69,111,49,623,69,19890
890,890,15000US060855029072,571,56,0,12,0,12,0,12,571,56,139,62,432,64,19891
891,891,15000US060855029081,805,140,0,12,0,12,0,12,805,140,103,82,702,161,19892
892,892,15000US060855029082,977,139,9,16,9,16,0,12,968,144,149,107,819,135,19893
893,893,15000US060855029083,640,138,0,12,0,12,0,12,640,138,168,110,472,134,19894
894,894,15000US060855029091,444,77,7,11,0,12,7,11,437,78,83,41,354,84,19895
895,895,15000US060855029092,321,64,0,12,0,12,0,12,321,64,31,23,290,64,19896
896,896,15000US060855029093,614,86,18,20,18,20,0,12,596,91,76,53,520,88,19897
897,897,15000US060855029094,698,104,110,83,7,11,103,85,588,108,65,37,523,108,19898
898,898,15000US060855029101,283,47,15,22,15,22,0,12,268,51,84,36,184,52,19899
899,899,15000US060855029102,303,63,8,12,0,12,8,12,295,64,72,47,223,62,19900
900,900,15000US060855029103,173,70,0,12,0,12,0,12,173,70,16,18,157,68,19901
901,901,15000US060855029104,614,92,8,12,8,12,0,12,606,92,38,25,568,97,19902
902,902,15000US060855030011,524,65,18,21,0,12,18,21,506,64,66,36,440,72,19903
903,903,15000US060855030012,382,68,0,12,0,12,0,12,382,68,103,51,279,70,19904
904,904,15000US060855030013,728,70,16,22,0,12,16,22,712,75,59,38,653,81,19905
905,905,15000US060855030021,534,83,51,54,11,13,40,52,483,87,126,49,357,88,19906
906,906,15000US060855030022,666,78,0,12,0,12,0,12,666,78,199,73,467,73,19907
907,907,15000US060855030031,361,63,12,18,0,12,12,18,349,64,98,45,251,72,19908
908,908,15000US060855030032,783,79,12,16,12,16,0,12,771,82,111,47,660,81,19909
909,909,15000US060855030033,490,66,34,45,6,10,28,44,456,64,97,58,359,72,19910
910,910,15000US060855030034,202,42,0,12,0,12,0,12,202,42,27,24,175,44,19911
911,911,15000US060855031051,765,46,109,43,40,28,69,37,656,58,239,74,417,67,19912
912,912,15000US060855031081,778,164,25,41,25,41,0,12,753,156,193,102,560,155,19913
913,913,15000US060855031082,1184,144,15,23,0,12,15,23,1169,142,85,63,1084,148,19914
914,914,15000US060855031083,452,157,0,12,0,12,0,12,452,157,107,56,345,169,19915
915,915,15000US060855031084,367,113,89,69,47,60,42,50,278,111,0,12,278,111,19916
916,916,15000US060855031101,603,74,173,72,23,31,150,67,430,81,38,36,392,78,19917
917,917,15000US060855031102,302,60,95,48,22,23,73,40,207,62,50,31,157,62,19918
918,918,15000US060855031103,246,58,116,64,0,12,116,64,130,63,19,22,111,61,19919
919,919,15000US060855031111,305,91,40,57,40,57,0,12,265,78,32,27,233,77,19920
920,920,15000US060855031112,382,101,12,19,12,19,0,12,370,97,85,45,285,98,19921
921,921,15000US060855031113,440,83,87,58,15,17,72,55,353,89,133,66,220,89,19922
922,922,15000US060855031121,1114,104,84,57,22,25,62,51,1030,117,143,60,887,121,19923
923,923,15000US060855031122,348,83,50,42,21,32,29,25,298,84,99,57,199,70,19924
924,924,15000US060855031131,587,89,54,43,38,39,16,17,533,93,126,62,407,84,19925
925,925,15000US060855031132,782,85,135,85,33,46,102,74,647,102,130,59,517,109,19926
926,926,15000US060855031151,2696,56,110,96,0,17,110,96,2586,112,387,116,2199,159,19927
927,927,15000US060855031161,1432,120,71,50,24,29,47,41,1361,139,236,114,1125,159,19928
928,928,15000US060855031162,844,115,55,51,29,35,26,37,789,128,140,102,649,132,19929
929,929,15000US060855031171,393,62,132,55,32,25,100,48,261,58,44,34,217,53,19930
930,930,15000US060855031172,375,64,91,51,33,25,58,41,284,63,94,33,190,62,19931
931,931,15000US060855031181,223,52,7,11,7,11,0,12,216,52,81,47,135,48,19932
932,932,15000US060855031182,635,89,107,70,0,12,107,70,528,99,66,31,462,99,19933
933,933,15000US060855031183,812,97,103,54,25,31,78,52,709,105,36,36,673,101,19934
934,934,15000US060855031211,1371,80,123,69,20,20,103,70,1248,90,136,69,1112,111,19935
935,935,15000US060855031212,130,48,22,25,9,14,13,21,108,43,19,22,89,42,19936
936,936,15000US060855031221,902,104,246,113,96,65,150,86,656,120,219,93,437,104,19937
937,937,15000US060855031222,252,69,49,40,38,36,11,17,203,65,33,23,170,63,19938
938,938,15000US060855031231,845,108,29,38,0,12,29,38,816,108,158,64,658,104,19939
939,939,15000US060855031232,799,92,154,87,88,63,66,56,645,100,231,69,414,104,19940
940,940,15000US060855032041,693,147,143,94,80,67,63,64,550,148,333,126,217,107,19941
941,941,15000US060855032042,456,102,23,39,23,39,0,12,433,96,51,44,382,95,19942
942,942,15000US060855032043,425,98,75,63,36,37,39,50,350,110,117,73,233,96,19943
943,943,15000US060855032044,88,65,14,26,0,12,14,26,74,64,25,39,49,50,19944
944,944,15000US060855032045,617,160,152,90,73,73,79,93,465,152,162,139,303,115,19945
945,945,15000US060855032071,658,59,41,33,23,20,18,20,617,60,121,43,496,67,19946
946,946,15000US060855032072,401,64,50,45,21,33,29,27,351,59,54,22,297,56,19947
947,947,15000US060855032081,563,53,131,65,42,38,89,58,432,68,170,45,262,72,19948
948,948,15000US060855032082,334,50,26,19,16,16,10,11,308,51,83,36,225,46,19949
949,949,15000US060855032101,574,54,92,44,40,30,52,34,482,62,120,51,362,67,19950
950,950,15000US060855032102,394,55,41,22,26,18,15,14,353,61,110,42,243,50,19951
951,951,15000US060855032111,588,79,27,30,11,16,16,25,561,81,91,42,470,91,19952
952,952,15000US060855032112,565,81,39,33,27,26,12,21,526,85,101,52,425,83,19953
953,953,15000US060855032121,204,36,29,18,6,9,23,16,175,38,54,27,121,36,19954
954,954,15000US060855032122,508,55,56,36,26,26,30,26,452,57,128,41,324,64,19955
955,955,15000US060855032123,245,46,2,5,2,5,0,12,243,48,50,27,193,48,19956
956,956,15000US060855032131,478,83,119,50,7,12,112,50,359,89,158,71,201,76,19957
957,957,15000US060855032132,786,85,162,69,58,43,104,63,624,92,176,80,448,104,19958
958,958,15000US060855032141,1420,151,434,136,160,91,274,119,986,150,255,104,731,141,19959
959,959,15000US060855032142,910,153,178,89,43,52,135,73,732,159,305,138,427,130,19960
960,960,15000US060855032171,504,108,120,61,31,33,89,64,384,117,38,35,346,116,19961
961,961,15000US060855032172,330,105,65,40,20,24,45,35,265,109,17,22,248,109,19962
962,962,15000US060855032173,259,85,45,53,4,8,41,54,214,85,92,69,122,58,19963
963,963,15000US060855032181,909,79,188,83,41,43,147,69,721,111,94,55,627,113,19964
964,964,15000US060855032182,272,69,41,39,5,8,36,38,231,71,76,44,155,75,19965
965,965,15000US060855033041,635,91,78,55,21,23,57,48,557,104,165,67,392,101,19966
966,966,15000US060855033042,515,64,77,48,42,37,35,34,438,69,68,45,370,74,19967
967,967,15000US060855033043,386,73,41,36,18,28,23,22,345,71,58,42,287,65,19968
968,968,15000US060855033044,372,72,19,22,19,22,0,12,353,73,131,59,222,71,19969
969,969,15000US060855033051,318,69,54,54,7,15,47,50,264,63,96,52,168,57,19970
970,970,15000US060855033052,622,101,58,44,0,12,58,44,564,102,136,67,428,124,19971
971,971,15000US060855033053,560,93,126,76,42,31,84,70,434,89,216,83,218,70,19972
972,972,15000US060855033061,251,42,15,7,11,8,4,7,236,42,114,39,122,40,19973
973,973,15000US060855033062,387,52,56,35,21,21,35,29,331,53,98,30,233,54,19974
974,974,15000US060855033063,268,44,31,17,15,16,16,14,237,48,79,34,158,45,19975
975,975,15000US060855033121,207,45,8,15,0,12,8,15,199,46,26,28,173,47,19976
976,976,15000US060855033122,562,68,0,12,0,12,0,12,562,68,56,41,506,74,19977
977,977,15000US060855033123,310,74,28,35,6,12,22,33,282,73,89,60,193,64,19978
978,978,15000US060855033131,446,50,12,19,12,19,0,12,434,52,59,38,375,59,19979
979,979,15000US060855033132,430,63,0,12,0,12,0,12,430,63,119,58,311,68,19980
980,980,15000US060855033133,421,68,0,12,0,12,0,12,421,68,50,47,371,71,19981
981,981,15000US060855033151,497,98,23,29,0,12,23,29,474,95,85,47,389,101,19982
982,982,15000US060855033152,327,82,20,21,6,10,14,17,307,84,32,21,275,84,19983
983,983,15000US060855033153,1216,105,79,62,47,49,32,36,1137,118,223,67,914,121,19984
984,984,15000US060855033211,448,53,33,26,16,17,17,20,415,58,179,63,236,63,19985
985,985,15000US060855033212,642,57,72,49,53,46,19,16,570,62,133,45,437,74,19986
986,986,15000US060855033221,357,50,16,13,11,11,5,8,341,50,86,33,255,58,19987
987,987,15000US060855033222,406,45,49,30,49,30,0,12,357,52,69,28,288,57,19988
988,988,15000US060855033223,304,45,27,27,13,21,14,17,277,48,52,27,225,52,19989
989,989,15000US060855033231,591,94,18,21,10,17,8,14,573,97,51,31,522,100,19990
990,990,15000US060855033232,592,79,50,36,8,11,42,35,542,84,178,82,364,89,19991
991,991,15000US060855033241,520,41,33,21,23,18,10,11,487,43,127,40,360,50,19992
992,992,15000US060855033242,388,41,13,13,6,8,7,10,375,41,63,29,312,48,19993
993,993,15000US060855033251,598,90,71,56,0,12,71,56,527,96,108,53,419,92,19994
994,994,15000US060855033252,559,83,34,35,21,31,13,19,525,80,211,76,314,80,19995
995,995,15000US060855033261,1267,75,59,53,15,23,44,48,1208,82,176,70,1032,104,19996
996,996,15000US060855033262,546,80,63,62,0,12,63,62,483,81,62,44,421,80,19997
997,997,15000US060855033271,463,83,67,45,27,31,40,33,396,87,154,68,242,76,19998
998,998,15000US060855033272,451,93,31,29,19,23,12,18,420,96,61,41,359,102,19999
999,999,15000US060855033273,519,81,8,14,0,12,8,14,511,82,303,72,208,70,20000
1000,1000,15000US060855033291,498,46,14,13,0,12,14,13,484,48,61,33,423,53,20001
1001,1001,15000US060855033292,482,46,7,8,7,8,0,12,475,47,90,38,385,47,20002
1002,1002,15000US060855033301,582,110,0,12,0,12,0,12,582,110,27,32,555,108,20003
1003,1003,15000US060855033302,520,98,0,12,0,12,0,12,520,98,0,12,520,98,20004
1004,1004,15000US060855033303,1056,105,26,29,0,12,26,29,1030,104,82,60,948,109,20005
1005,1005,15000US060855033311,1005,80,49,29,30,26,19,19,956,80,310,83,646,91,20006
1006,1006,15000US060855033312,355,53,20,27,20,27,0,12,335,51,55,38,280,55,20007
1007,1007,15000US060855033321,928,81,0,12,0,12,0,12,928,81,383,116,545,119,20008
1008,1008,15000US060855033322,406,71,0,12,0,12,0,12,406,71,161,63,245,73,20009
1009,1009,15000US060855033323,301,77,0,12,0,12,0,12,301,77,21,22,280,75,20010
1010,1010,15000US060855033324,944,93,0,12,0,12,0,12,944,93,216,95,728,105,20011
1011,1011,15000US060855033331,465,74,0,12,0,12,0,12,465,74,69,40,396,76,20012
1012,1012,15000US060855033332,831,76,19,22,6,12,13,20,812,81,201,84,611,98,20013
1013,1013,15000US060855033341,1279,143,36,40,15,26,21,33,1243,144,98,60,1145,138,20014
1014,1014,15000US060855033342,494,104,0,12,0,12,0,12,494,104,72,60,422,99,20015
1015,1015,15000US060855033343,752,108,0,12,0,12,0,12,752,108,49,47,703,114,20016
1016,1016,15000US060855033361,390,43,41,28,12,12,29,27,349,55,52,24,297,56,20017
1017,1017,15000US060855033362,505,46,32,22,5,9,27,20,473,52,161,53,312,60,20018
1018,1018,15000US060855033371,634,61,31,19,14,11,17,17,603,62,172,60,431,67,20019
1019,1019,15000US060855033372,327,52,8,9,0,12,8,9,319,52,54,26,265,54,20020
1020,1020,15000US060855034011,218,58,38,34,23,31,15,16,180,53,38,26,142,53,20021
1021,1021,15000US060855034012,356,69,26,24,26,24,0,12,330,70,97,38,233,62,20022
1022,1022,15000US060855034013,374,59,18,14,5,8,13,12,356,57,82,37,274,60,20023
1023,1023,15000US060855034021,0,12,0,12,0,12,0,12,0,12,0,12,0,12,20024
1024,1024,15000US060855034022,520,95,208,91,53,46,155,84,312,81,66,43,246,79,20025
1025,1025,15000US060855034023,735,98,138,76,42,37,96,68,597,112,196,67,401,107,20026
1026,1026,15000US060855035041,292,82,107,72,22,31,85,65,185,67,66,48,119,62,20027
1027,1027,15000US060855035042,358,86,72,57,11,18,61,55,286,90,72,51,214,79,20028
1028,1028,15000US060855035043,271,92,32,38,12,20,20,33,239,90,12,18,227,91,20029
1029,1029,15000US060855035044,157,74,34,43,0,12,34,43,123,61,9,15,114,62,20030
1030,1030,15000US060855035045,140,46,0,12,0,12,0,12,140,46,20,15,120,47,20031
1031,1031,15000US060855035061,554,82,97,59,58,51,39,27,457,81,76,55,381,80,20032
1032,1032,15000US060855035062,491,82,39,30,22,27,17,21,452,87,134,48,318,83,20033
1033,1033,15000US060855035063,245,57,6,9,0,12,6,9,239,59,58,35,181,60,20034
1034,1034,15000US060855035071,283,27,39,19,5,7,34,18,244,32,46,22,198,37,20035
1035,1035,15000US060855035072,106,25,25,18,8,12,17,17,81,23,22,14,59,23,20036
1036,1036,15000US060855035081,788,87,167,89,44,46,123,81,621,101,185,87,436,105,20037
1037,1037,15000US060855035082,479,79,92,51,43,44,49,45,387,85,109,56,278,89,20038
1038,1038,15000US060855035091,454,61,24,21,0,12,24,21,430,58,102,49,328,73,20039
1039,1039,15000US060855035092,188,56,28,35,0,12,28,35,160,49,7,10,153,49,20040
1040,1040,15000US060855035093,259,41,12,12,0,12,12,12,247,42,51,27,196,43,20041
1041,1041,15000US060855035101,733,92,157,79,36,34,121,77,576,101,121,51,455,97,20042
1042,1042,15000US060855035102,291,71,11,20,11,20,0,12,280,70,87,38,193,71,20043
1043,1043,15000US060855035103,383,75,45,42,0,12,45,42,338,76,85,36,253,74,20044
1044,1044,15000US060855035111,401,54,11,13,11,13,0,12,390,55,104,46,286,52,20045
1045,1045,15000US060855035112,464,51,32,27,11,16,21,22,432,49,136,37,296,58,20046
1046,1046,15000US060855036011,276,56,17,19,11,17,6,8,259,56,45,29,214,50,20047
1047,1047,15000US060855036012,605,60,53,32,17,14,36,30,552,67,166,45,386,67,20048
1048,1048,15000US060855036021,449,77,50,39,0,12,50,39,399,89,54,38,345,92,20049
1049,1049,15000US060855036022,670,76,108,54,13,15,95,54,562,89,202,67,360,86,20050
1050,1050,15000US060855036023,233,63,71,42,7,16,64,42,162,63,69,53,93,45,20051
1051,1051,15000US060855037031,179,48,23,17,6,9,17,16,156,50,29,19,127,55,20052
1052,1052,15000US060855037032,294,54,59,30,22,18,37,29,235,56,82,34,153,53,20053
1053,1053,15000US060855037033,480,70,113,49,26,20,87,48,367,71,73,36,294,70,20054
1054,1054,15000US060855037071,617,89,184,91,18,25,166,86,433,101,45,32,388,98,20055
1055,1055,15000US060855037072,562,73,72,41,10,15,62,40,490,80,113,49,377,85,20056
1056,1056,15000US060855037073,252,65,27,25,17,19,10,14,225,64,42,33,183,61,20057
1057,1057,15000US060855037081,579,46,56,30,26,18,30,28,523,53,144,58,379,59,20058
1058,1058,15000US060855037082,183,48,15,14,9,11,6,9,168,48,45,27,123,46,20059
1059,1059,15000US060855037091,726,82,164,86,27,33,137,80,562,95,171,79,391,113,20060
1060,1060,15000US060855037092,408,86,191,78,64,44,127,71,217,78,117,60,100,58,20061
1061,1061,15000US060855037093,564,82,135,52,72,44,63,40,429,84,175,63,254,87,20062
1062,1062,15000US060855037101,505,81,222,83,25,21,197,81,283,88,145,68,138,71,20063
1063,1063,15000US060855037102,539,71,89,42,36,29,53,30,450,63,113,44,337,68,20064
1064,1064,15000US060855037111,258,57,33,32,18,23,15,24,225,58,58,32,167,58,20065
1065,1065,15000US060855037112,426,69,101,47,20,14,81,46,325,62,91,37,234,58,20066
1066,1066,15000US060855037113,354,56,53,33,15,22,38,25,301,58,60,29,241,55,20067
1067,1067,15000US060855037121,307,60,18,19,9,15,9,12,289,59,90,56,199,58,20068
1068,1068,15000US060855037122,1062,66,147,71,33,30,114,68,915,93,207,75,708,117,20069
1069,1069,15000US060855037131,946,71,76,51,74,51,2,10,870,81,260,91,610,101,20070
1070,1070,15000US060855037132,226,60,28,34,3,13,25,33,198,61,37,40,161,57,20071
1071,1071,15000US060855038021,1018,117,39,50,8,17,31,48,979,132,396,142,583,137,20072
1072,1072,15000US060855038022,241,82,21,32,0,12,21,32,220,76,0,12,220,76,20073
1073,1073,15000US060855038023,301,115,24,31,0,12,24,31,277,110,115,99,162,104,20074
1074,1074,15000US060855038024,692,120,53,49,27,32,26,39,639,120,133,89,506,123,20075
1075,1075,15000US060855038031,1007,97,26,23,16,17,10,16,981,98,156,57,825,98,20076
1076,1076,15000US060855038032,410,78,47,40,39,37,8,14,363,74,65,47,298,78,20077
1077,1077,15000US060855038041,651,100,56,56,0,12,56,56,595,116,100,53,495,113,20078
1078,1078,15000US060855038042,359,92,44,44,17,21,27,42,315,93,80,39,235,89,20079
1079,1079,15000US060855038043,654,113,9,14,0,12,9,14,645,113,105,49,540,114,20080
1080,1080,15000US060855039021,482,91,72,46,13,19,59,43,410,90,64,41,346,93,20081
1081,1081,15000US060855039022,272,83,44,48,8,12,36,52,228,76,135,73,93,56,20082
1082,1082,15000US060855039023,318,76,34,37,0,12,34,37,284,77,40,25,244,79,20083
1083,1083,15000US060855039024,461,93,49,48,12,17,37,45,412,98,56,32,356,101,20084
1084,1084,15000US060855039031,623,57,100,47,23,24,77,51,523,63,125,46,398,65,20085
1085,1085,15000US060855039032,313,53,20,24,0,12,20,24,293,56,79,45,214,56,20086
1086,1086,15000US060855040011,395,94,110,77,0,12,110,77,285,73,91,40,194,72,20087
1087,1087,15000US060855040012,551,103,35,43,0,12,35,43,516,101,103,63,413,99,20088
1088,1088,15000US060855040013,621,108,104,58,20,22,84,54,517,111,122,61,395,110,20089
1089,1089,15000US060855040021,690,82,86,46,19,22,67,40,604,84,191,68,413,74,20090
1090,1090,15000US060855040022,740,80,223,67,84,53,139,60,517,94,102,58,415,102,20091
1091,1091,15000US060855041011,347,77,40,36,5,7,35,35,307,78,90,48,217,69,20092
1092,1092,15000US060855041012,748,82,65,35,24,24,41,29,683,84,161,61,522,97,20093
1093,1093,15000US060855041021,661,96,28,28,7,11,21,26,633,92,98,49,535,88,20094
1094,1094,15000US060855041022,325,75,23,24,23,24,0,12,302,75,37,33,265,79,20095
1095,1095,15000US060855041023,366,94,56,51,0,12,56,51,310,86,18,19,292,89,20096
1096,1096,15000US060855042011,968,87,27,27,6,10,21,24,941,93,226,88,715,112,20097
1097,1097,15000US060855042012,374,60,4,12,0,12,4,12,370,61,96,50,274,60,20098
1098,1098,15000US060855042013,464,65,0,12,0,12,0,12,464,65,101,39,363,74,20099
1099,1099,15000US060855042021,355,62,0,12,0,12,0,12,355,62,72,36,283,57,20100
1100,1100,15000US060855042022,608,100,0,12,0,12,0,12,608,100,96,59,512,106,20101
1101,1101,15000US060855042023,510,79,12,16,0,12,12,16,498,80,68,42,430,86,20102
1102,1102,15000US060855043071,762,85,19,21,19,21,0,12,743,84,119,43,624,84,20103
1103,1103,15000US060855043072,954,81,46,51,28,42,18,18,908,81,200,66,708,96,20104
1104,1104,15000US060855043081,583,57,29,25,0,12,29,25,554,63,89,43,465,67,20105
1105,1105,15000US060855043082,508,62,25,33,25,33,0,12,483,63,171,72,312,57,20106
1106,1106,15000US060855043083,434,55,0,12,0,12,0,12,434,55,150,54,284,69,20107
1107,1107,15000US060855043111,1006,125,13,21,0,12,13,21,993,126,92,59,901,134,20108
1108,1108,15000US060855043112,928,119,48,77,48,77,0,12,880,115,96,85,784,117,20109
1109,1109,15000US060855043113,477,81,18,27,18,27,0,12,459,87,111,78,348,113,20110
1110,1110,15000US060855043141,289,56,49,51,10,16,39,48,240,55,75,49,165,49,20111
1111,1111,15000US060855043142,333,64,0,12,0,12,0,12,333,64,53,31,280,63,20112
1112,1112,15000US060855043143,307,50,39,50,0,12,39,50,268,58,30,27,238,59,20113
1113,1113,15000US060855043144,404,64,30,38,7,11,23,36,374,69,25,21,349,72,20114
1114,1114,15000US060855043151,607,91,29,24,0,12,29,24,578,93,47,31,531,94,20115
1115,1115,15000US060855043152,288,60,0,12,0,12,0,12,288,60,81,34,207,70,20116
1116,1116,15000US060855043153,406,72,0,12,0,12,0,12,406,72,48,33,358,76,20117
1117,1117,15000US060855043154,270,65,0,12,0,12,0,12,270,65,56,35,214,64,20118
1118,1118,15000US060855043155,429,84,85,67,30,47,55,52,344,81,50,42,294,83,20119
1119,1119,15000US060855043161,672,91,63,64,10,16,53,61,609,86,136,58,473,85,20120
1120,1120,15000US060855043162,476,79,10,15,0,12,10,15,466,81,49,36,417,87,20121
1121,1121,15000US060855043163,261,64,18,20,18,20,0,12,243,67,56,37,187,66,20122
1122,1122,15000US060855043171,636,84,23,20,7,10,16,18,613,89,126,76,487,97,20123
1123,1123,15000US060855043172,562,93,18,20,8,12,10,16,544,92,132,57,412,102,20124
1124,1124,15000US060855043181,922,92,38,27,0,12,38,27,884,94,141,55,743,102,20125
1125,1125,15000US060855043182,40,28,0,12,0,12,0,12,40,28,8,13,32,32,20126
1126,1126,15000US060855043183,543,78,86,50,19,22,67,52,457,82,90,44,367,87,20127
1127,1127,15000US060855043191,717,120,16,25,16,25,0,12,701,118,63,48,638,119,20128
1128,1128,15000US060855043192,528,93,0,12,0,12,0,12,528,93,82,45,446,101,20129
1129,1129,15000US060855043193,816,103,24,39,0,12,24,39,792,113,151,86,641,129,20130
1130,1130,15000US060855043201,522,53,7,11,7,11,0,12,515,52,97,42,418,60,20131
1131,1131,15000US060855043202,322,47,8,12,0,12,8,12,314,46,101,45,213,41,20132
1132,1132,15000US060855043211,704,75,21,23,10,17,11,17,683,78,88,51,595,82,20133
1133,1133,15000US060855043212,489,80,29,46,0,12,29,46,460,78,47,43,413,83,20134
1134,1134,15000US060855043213,396,60,25,40,0,12,25,40,371,62,116,53,255,70,20135
1135,1135,15000US060855043221,547,112,10,18,0,12,10,18,537,111,65,51,472,117,20136
1136,1136,15000US060855043222,602,107,25,38,0,12,25,38,577,101,33,38,544,108,20137
1137,1137,15000US060855043223,894,157,0,12,0,12,0,12,894,157,78,67,816,165,20138
1138,1138,15000US060855043231,387,78,51,52,9,13,42,49,336,68,85,43,251,68,20139
1139,1139,15000US060855043232,1283,109,0,12,0,12,0,12,1283,109,96,75,1187,133,20140
1140,1140,15000US060855043233,223,73,0,12,0,12,0,12,223,73,12,16,211,73,20141
1141,1141,15000US060855044101,534,65,67,48,33,48,34,28,467,64,113,50,354,71,20142
1142,1142,15000US060855044102,658,70,51,27,51,27,0,12,607,69,184,56,423,70,20143
1143,1143,15000US060855044111,848,78,43,34,30,28,13,19,805,79,150,57,655,90,20144
1144,1144,15000US060855044112,713,78,0,12,0,12,0,12,713,78,123,51,590,82,20145
1145,1145,15000US060855044121,313,62,14,20,0,12,14,20,299,60,107,56,192,57,20146
1146,1146,15000US060855044122,312,81,9,14,0,12,9,14,303,80,41,40,262,79,20147
1147,1147,15000US060855044123,448,78,74,58,24,23,50,55,374,88,57,44,317,91,20148
1148,1148,15000US060855044124,269,62,13,19,0,12,13,19,256,62,38,30,218,59,20149
1149,1149,15000US060855044131,721,29,5,9,0,12,5,9,716,32,195,53,521,55,20150
1150,1150,15000US060855044141,819,108,37,43,11,18,26,38,782,112,131,64,651,103,20151
1151,1151,15000US060855044142,368,81,14,21,0,12,14,21,354,82,50,33,304,81,20152
1152,1152,15000US060855044143,365,78,9,15,9,15,0,12,356,79,86,57,270,69,20153
1153,1153,15000US060855044151,599,80,0,12,0,12,0,12,599,80,40,29,559,78,20154
1154,1154,15000US060855044152,461,59,27,32,9,14,18,28,434,69,170,68,264,72,20155
1155,1155,15000US060855044153,533,70,17,19,17,19,0,12,516,72,77,48,439,84,20156
1156,1156,15000US060855044161,552,69,13,19,13,19,0,12,539,68,57,34,482,73,20157
1157,1157,15000US060855044162,564,69,26,27,0,12,26,27,538,75,110,58,428,74,20158
1158,1158,15000US060855044171,129,34,15,23,0,12,15,23,114,28,16,11,98,29,20159
1159,1159,15000US060855044181,613,90,135,96,51,64,84,74,478,102,62,51,416,106,20160
1160,1160,15000US060855044182,548,75,49,33,49,33,0,12,499,71,106,51,393,77,20161
1161,1161,15000US060855044183,191,45,8,14,8,14,0,12,183,44,21,21,162,41,20162
1162,1162,15000US060855044201,732,78,47,42,12,17,35,48,685,83,85,44,600,85,20163
1163,1163,15000US060855044202,494,92,11,18,0,12,11,18,483,92,57,37,426,96,20164
1164,1164,15000US060855044203,190,51,26,26,16,21,10,16,164,48,30,27,134,46,20165
1165,1165,15000US060855044211,399,69,9,15,9,15,0,12,390,68,123,59,267,71,20166
1166,1166,15000US060855044212,486,73,0,12,0,12,0,12,486,73,106,43,380,79,20167
1167,1167,15000US060855044213,499,69,12,19,0,12,12,19,487,70,141,50,346,72,20168
1168,1168,15000US060855044221,533,66,81,39,29,22,52,34,452,61,172,45,280,57,20169
1169,1169,15000US060855044222,528,69,38,33,31,31,7,11,490,70,81,31,409,70,20170
1170,1170,15000US060855044231,691,20,22,20,22,20,0,12,669,27,159,51,510,52,20171
1171,1171,15000US060855045041,257,101,0,12,0,12,0,12,257,101,32,48,225,96,20172
1172,1172,15000US060855045042,0,12,0,12,0,12,0,12,0,12,0,12,0,12,20173
1173,1173,15000US060855045043,361,86,0,12,0,12,0,12,361,86,0,12,361,86,20174
1174,1174,15000US060855045044,2281,153,48,55,18,29,30,45,2233,167,119,75,2114,173,20175
1175,1175,15000US060855045051,197,50,78,47,30,32,48,34,119,46,12,16,107,44,20176
1176,1176,15000US060855045052,695,93,23,25,23,25,0,12,672,93,153,60,519,107,20177
1177,1177,15000US060855045053,1128,110,44,40,9,14,35,37,1084,113,89,40,995,121,20178
1178,1178,15000US060855045061,457,153,0,12,0,12,0,12,457,153,81,90,376,148,20179
1179,1179,15000US060855045062,989,155,34,38,10,23,24,32,955,146,49,40,906,153,20180
1180,1180,15000US060855045063,798,159,13,21,0,12,13,21,785,158,193,117,592,169,20181
1181,1181,15000US060855045071,360,89,27,41,27,41,0,12,333,76,85,33,248,77,20182
1182,1182,15000US060855045072,515,104,33,27,15,16,18,21,482,105,95,56,387,105,20183
1183,1183,15000US060855045073,499,91,20,21,10,16,10,14,479,93,83,50,396,99,20184
1184,1184,15000US060855045074,457,77,0,12,0,12,0,12,457,77,145,65,312,79,20185
1185,1185,15000US060855046011,353,25,13,12,9,11,4,6,340,27,55,27,285,37,20186
1186,1186,15000US060855046021,635,56,65,38,20,16,45,34,570,58,91,42,479,56,20187
1187,1187,15000US060855047001,200,60,18,21,0,12,18,21,182,58,25,22,157,55,20188
1188,1188,15000US060855048021,813,105,19,20,6,10,13,17,794,105,130,66,664,111,20189
1189,1189,15000US060855048022,297,59,0,12,0,12,0,12,297,59,75,38,222,68,20190
1190,1190,15000US060855048023,687,99,4,12,4,12,0,12,683,100,96,48,587,101,20191
1191,1191,15000US060855048031,552,105,22,30,0,12,22,30,530,112,69,54,461,109,20192
1192,1192,15000US060855048032,1939,142,0,12,0,12,0,12,1939,142,170,87,1769,163,20193
1193,1193,15000US060855048051,1764,156,69,70,26,44,43,57,1695,169,345,129,1350,181,20194
1194,1194,15000US060855048052,930,123,0,12,0,12,0,12,930,123,228,94,702,133,20195
1195,1195,15000US060855048061,350,33,11,12,6,9,5,8,339,37,57,25,282,42,20196
1196,1196,15000US060855048062,425,44,37,21,19,16,18,15,388,48,97,32,291,54,20197
1197,1197,15000US060855049011,4123,158,26,41,26,41,0,19,4097,160,181,117,3916,196,20198
1198,1198,15000US060855050011,1039,149,48,46,0,12,48,46,991,146,123,73,868,149,20199
1199,1199,15000US060855050012,912,177,0,12,0,12,0,12,912,177,18,26,894,180,20200
1200,1200,15000US060855050013,896,147,17,30,17,30,0,12,879,147,77,63,802,154,20201
1201,1201,15000US060855050014,184,71,15,34,0,12,15,34,169,66,16,26,153,60,20202
1202,1202,15000US060855050015,419,104,0,12,0,12,0,12,419,104,48,44,371,115,20203
1203,1203,15000US060855050061,971,153,0,12,0,12,0,12,971,153,82,85,889,148,20204
1204,1204,15000US060855050062,2280,199,0,12,0,12,0,12,2280,199,34,45,2246,201,20205
1205,1205,15000US060855050071,250,60,13,12,7,8,6,9,237,59,65,27,172,54,20206
1206,1206,15000US060855050072,702,62,64,30,18,15,46,28,638,62,131,48,507,70,20207
1207,1207,15000US060855050081,2422,196,11,20,0,17,11,20,2411,196,105,74,2306,210,20208
1208,1208,15000US060855050082,40,65,0,12,0,12,0,12,40,65,0,12,40,65,20209
1209,1209,15000US060855050091,1389,198,61,66,39,56,22,31,1328,209,299,126,1029,223,20210
1210,1210,15000US060855050092,431,107,53,49,19,31,34,39,378,121,93,63,285,104,20211
1211,1211,15000US060855050093,1532,202,38,42,23,34,15,26,1494,208,139,77,1355,206,20212
1212,1212,15000US060855051001,1633,81,86,47,69,45,17,18,1547,94,285,84,1262,113,20213
1213,1213,15000US060855051002,37,31,14,22,14,22,0,12,23,29,8,18,15,25,20214
1214,1214,15000US060855052021,624,146,43,38,28,30,15,23,581,147,160,88,421,144,20215
1215,1215,15000US060855052022,1269,139,54,56,14,21,40,51,1215,148,285,98,930,147,20216
1216,1216,15000US060855052023,481,99,140,78,76,80,64,71,341,109,38,36,303,107,20217
1217,1217,15000US060855052031,1005,95,12,13,0,12,12,13,993,98,39,28,954,100,20218
1218,1218,15000US060855052032,442,79,42,38,42,38,0,12,400,76,80,58,320,79,20219
1219,1219,15000US060855053011,369,74,18,20,0,12,18,20,351,82,82,37,269,90,20220
1220,1220,15000US060855053012,284,63,14,15,14,15,0,12,270,68,56,37,214,69,20221
1221,1221,15000US060855053013,226,56,0,12,0,12,0,12,226,56,69,41,157,47,20222
1222,1222,15000US060855053014,533,105,46,46,0,12,46,46,487,112,59,41,428,114,20223
1223,1223,15000US060855053021,949,94,30,29,16,19,14,22,919,102,191,70,728,118,20224
1224,1224,15000US060855053022,438,70,27,30,0,12,27,30,411,68,82,46,329,70,20225
1225,1225,15000US060855053031,675,137,0,12,0,12,0,12,675,137,63,47,612,137,20226
1226,1226,15000US060855053032,598,125,0,12,0,12,0,12,598,125,68,52,530,139,20227
1227,1227,15000US060855053033,182,51,0,12,0,12,0,12,182,51,34,37,148,58,20228
1228,1228,15000US060855053034,708,134,150,79,12,20,138,77,558,147,151,62,407,148,20229
1229,1229,15000US060855053041,278,58,0,12,0,12,0,12,278,58,49,32,229,56,20230
1230,1230,15000US060855053042,313,45,0,12,0,12,0,12,313,45,81,41,232,43,20231
1231,1231,15000US060855053043,211,51,0,12,0,12,0,12,211,51,55,44,156,46,20232
1232,1232,15000US060855053044,297,68,0,12,0,12,0,12,297,68,42,34,255,73,20233
1233,1233,15000US060855053051,528,118,20,30,20,30,0,12,508,124,215,99,293,100,20234
1234,1234,15000US060855053052,366,94,0,12,0,12,0,12,366,94,31,39,335,100,20235
1235,1235,15000US060855053053,775,129,0,12,0,12,0,12,775,129,118,98,657,148,20236
1236,1236,15000US060855053054,407,89,4,10,0,12,4,10,403,93,24,32,379,87,20237
1237,1237,15000US060855054011,209,89,18,28,18,28,0,12,191,92,23,25,168,91,20238
1238,1238,15000US060855054012,825,130,0,12,0,12,0,12,825,130,23,31,802,133,20239
1239,1239,15000US060855054013,940,157,0,12,0,12,0,12,940,157,58,69,882,166,20240
1240,1240,15000US060855054014,368,72,0,12,0,12,0,12,368,72,142,65,226,71,20241
1241,1241,15000US060855054015,239,93,0,12,0,12,0,12,239,93,101,65,138,100,20242
1242,1242,15000US060855054021,368,68,0,12,0,12,0,12,368,68,68,38,300,79,20243
1243,1243,15000US060855054022,769,78,39,35,26,26,13,21,730,82,86,41,644,87,20244
1244,1244,15000US060855054031,739,126,19,33,19,33,0,12,720,127,89,58,631,125,20245
1245,1245,15000US060855054032,812,175,11,17,0,12,11,17,801,176,138,85,663,164,20246
1246,1246,15000US060855054033,1016,153,34,50,0,12,34,50,982,148,129,70,853,158,20247
1247,1247,15000US060855055001,325,61,0,12,0,12,0,12,325,61,58,31,267,67,20248
1248,1248,15000US060855055002,758,90,0,12,0,12,0,12,758,90,128,59,630,104,20249
1249,1249,15000US060855055003,495,66,19,30,0,12,19,30,476,68,83,42,393,69,20250
1250,1250,15000US060855056001,487,88,20,20,10,15,10,15,467,92,98,47,369,97,20251
1251,1251,15000US060855056002,252,61,0,12,0,12,0,12,252,61,86,55,166,52,20252
1252,1252,15000US060855056003,496,74,0,12,0,12,0,12,496,74,84,41,412,71,20253
1253,1253,15000US060855057001,316,103,0,12,0,12,0,12,316,103,26,37,290,102,20254
1254,1254,15000US060855057002,483,110,44,69,44,69,0,12,439,100,102,68,337,98,20255
1255,1255,15000US060855057003,715,140,0,12,0,12,0,12,715,140,37,57,678,135,20256
1256,1256,15000US060855057004,947,160,74,74,0,12,74,74,873,156,43,40,830,161,20257
1257,1257,15000US060855058001,417,82,7,11,0,12,7,11,410,80,50,33,360,86,20258
1258,1258,15000US060855058002,334,72,0,12,0,12,0,12,334,72,47,36,287,74,20259
1259,1259,15000US060855058003,375,56,0,12,0,12,0,12,375,56,73,46,302,52,20260
1260,1260,15000US060855058004,424,74,34,37,34,37,0,12,390,77,49,47,341,65,20261
1261,1261,15000US060855059001,1066,142,89,102,0,12,89,102,977,155,155,100,822,149,20262
1262,1262,15000US060855059002,463,121,0,12,0,12,0,12,463,121,178,87,285,125,20263
1263,1263,15000US060855059003,343,51,0,12,0,12,0,12,343,51,102,43,241,62,20264
1264,1264,15000US060855059004,738,130,20,31,20,31,0,12,718,133,90,64,628,137,20265
1265,1265,15000US060855059005,506,96,0,12,0,12,0,12,506,96,99,58,407,120,20266
1266,1266,15000US060855060001,405,85,29,37,0,12,29,37,376,84,88,47,288,84,20267
1267,1267,15000US060855060002,284,56,8,12,8,12,0,12,276,54,67,32,209,59,20268
1268,1268,15000US060855060003,863,95,0,12,0,12,0,12,863,95,57,38,806,95,20269
1269,1269,15000US060855060004,262,71,14,20,14,20,0,12,248,72,19,21,229,73,20270
1270,1270,15000US060855061011,423,68,17,25,17,25,0,12,406,70,136,54,270,69,20271
1271,1271,15000US060855061012,664,97,23,21,8,12,15,18,641,97,87,39,554,105,20272
1272,1272,15000US060855061013,643,82,0,12,0,12,0,12,643,82,129,61,514,84,20273
1273,1273,15000US060855061021,529,60,7,11,0,12,7,11,522,61,100,44,422,65,20274
1274,1274,15000US060855061022,964,80,0,12,0,12,0,12,964,80,189,62,775,87,20275
1275,1275,15000US060855061031,674,69,10,16,10,16,0,12,664,72,115,59,549,88,20276
1276,1276,15000US060855061032,272,49,0,12,0,12,0,12,272,49,43,27,229,51,20277
1277,1277,15000US060855061033,306,56,0,12,0,12,0,12,306,56,62,29,244,59,20278
1278,1278,15000US060855061034,393,65,0,12,0,12,0,12,393,65,61,31,332,75,20279
1279,1279,15000US060855062021,619,96,17,26,0,12,17,26,602,98,66,49,536,97,20280
1280,1280,15000US060855062022,935,107,0,12,0,12,0,12,935,107,113,70,822,112,20281
1281,1281,15000US060855062023,961,136,0,12,0,12,0,12,961,136,274,108,687,138,20282
1282,1282,15000US060855062031,547,138,9,16,0,12,9,16,538,139,69,73,469,145,20283
1283,1283,15000US060855062032,989,135,109,87,18,27,91,83,880,136,216,97,664,141,20284
1284,1284,15000US060855062033,843,143,0,12,0,12,0,12,843,143,80,79,763,144,20285
1285,1285,15000US060855062041,774,121,0,12,0,12,0,12,774,121,140,91,634,117,20286
1286,1286,15000US060855062042,473,100,14,23,0,12,14,23,459,103,46,41,413,101,20287
1287,1287,15000US060855062043,357,58,0,12,0,12,0,12,357,58,88,53,269,66,20288
1288,1288,15000US060855062044,482,104,0,12,0,12,0,12,482,104,68,68,414,100,20289
1289,1289,15000US060855063011,553,135,0,12,0,12,0,12,553,135,76,70,477,121,20290
1290,1290,15000US060855063012,866,164,109,72,42,46,67,61,757,179,95,71,662,176,20291
1291,1291,15000US060855063013,524,111,17,28,17,28,0,12,507,109,118,77,389,107,20292
1292,1292,15000US060855063014,347,107,0,12,0,12,0,12,347,107,77,58,270,103,20293
1293,1293,15000US060855063021,1070,158,51,81,0,12,51,81,1019,157,118,89,901,173,20294
1294,1294,15000US060855063022,717,130,0,12,0,12,0,12,717,130,124,68,593,134,20295
1295,1295,15000US060855063023,717,108,55,56,33,46,22,28,662,118,185,109,477,118,20296
1296,1296,15000US060855063041,776,133,77,73,22,32,55,65,699,117,89,56,610,123,20297
1297,1297,15000US060855063042,209,93,44,65,0,12,44,65,165,65,31,30,134,68,20298
1298,1298,15000US060855063043,1103,153,27,34,0,12,27,34,1076,159,62,65,1014,160,20299
1299,1299,15000US060855063051,386,132,155,114,72,88,83,99,231,100,29,34,202,101,20300
1300,1300,15000US060855063052,899,128,42,42,0,12,42,42,857,136,113,66,744,147,20301
1301,1301,15000US060855063053,570,124,5,11,0,12,5,11,565,124,103,61,462,118,20302
1302,1302,15000US060855063054,714,143,26,28,18,24,8,13,688,147,206,107,482,150,20303
1303,1303,15000US060855064011,1070,120,92,72,0,12,92,72,978,109,220,76,758,113,20304
1304,1304,15000US060855064012,1033,148,20,28,20,28,0,12,1013,155,155,71,858,143,20305
1305,1305,15000US060855064021,718,118,49,50,15,23,34,46,669,121,144,87,525,113,20306
1306,1306,15000US060855064022,240,50,0,12,0,12,0,12,240,50,55,40,185,64,20307
1307,1307,15000US060855064023,929,133,92,70,67,70,25,30,837,132,186,92,651,123,20308
1308,1308,15000US060855064024,366,101,19,30,0,12,19,30,347,99,53,35,294,97,20309
1309,1309,15000US060855065011,621,155,175,99,132,90,43,53,446,139,71,46,375,136,20310
1310,1310,15000US060855065012,1225,171,117,79,44,55,73,61,1108,174,255,105,853,174,20311
1311,1311,15000US060855065013,641,134,165,100,7,13,158,100,476,141,107,91,369,129,20312
1312,1312,15000US060855065021,704,70,50,56,28,46,22,35,654,86,81,55,573,73,20313
1313,1313,15000US060855065022,381,76,16,17,0,12,16,17,365,78,36,26,329,77,20314
1314,1314,15000US060855065023,793,94,21,23,0,12,21,23,772,94,104,49,668,96,20315
1315,1315,15000US060855065031,880,150,14,22,0,12,14,22,866,153,215,109,651,137,20316
1316,1316,15000US060855065032,770,128,12,20,12,20,0,12,758,128,234,102,524,124,20317
1317,1317,15000US060855065033,959,157,39,65,39,65,0,12,920,154,171,100,749,158,20318
1318,1318,15000US060855066011,678,76,0,12,0,12,0,12,678,76,101,54,577,91,20319
1319,1319,15000US060855066012,278,58,16,23,16,23,0,12,262,58,16,13,246,57,20320
1320,1320,15000US060855066013,737,98,40,45,27,42,13,14,697,95,105,51,592,94,20321
1321,1321,15000US060855066031,234,49,0,12,0,12,0,12,234,49,51,28,183,49,20322
1322,1322,15000US060855066032,667,74,21,22,0,12,21,22,646,73,190,56,456,89,20323
1323,1323,15000US060855066033,439,69,77,73,0,12,77,73,362,60,74,49,288,63,20324
1324,1324,15000US060855066041,309,83,0,12,0,12,0,12,309,83,27,32,282,78,20325
1325,1325,15000US060855066042,598,95,0,12,0,12,0,12,598,95,79,54,519,105,20326
1326,1326,15000US060855066043,584,95,0,12,0,12,0,12,584,95,172,105,412,93,20327
1327,1327,15000US060855066044,522,87,0,12,0,12,0,12,522,87,75,49,447,96,20328
1328,1328,15000US060855066045,549,85,0,12,0,12,0,12,549,85,91,60,458,99,20329
1329,1329,15000US060855066051,894,93,0,12,0,12,0,12,894,93,99,44,795,95,20330
1330,1330,15000US060855066052,614,81,22,29,0,12,22,29,592,78,126,48,466,85,20331
1331,1331,15000US060855066061,251,61,8,12,0,12,8,12,243,61,56,40,187,60,20332
1332,1332,15000US060855066062,809,105,6,12,0,12,6,12,803,106,209,87,594,103,20333
1333,1333,15000US060855066063,536,87,52,37,0,12,52,37,484,84,72,41,412,83,20334
1334,1334,15000US060855067011,282,51,23,25,13,20,10,15,259,59,12,19,247,59,20335
1335,1335,15000US060855067012,521,73,19,21,8,13,11,16,502,75,81,44,421,71,20336
1336,1336,15000US060855067013,450,62,11,17,11,17,0,12,439,63,51,26,388,61,20337
1337,1337,15000US060855067021,633,121,80,70,31,34,49,61,553,108,113,80,440,101,20338
1338,1338,15000US060855067022,747,121,7,16,0,12,7,16,740,122,137,88,603,113,20339
1339,1339,15000US060855067023,555,113,16,27,0,12,16,27,539,111,77,52,462,113,20340
1340,1340,15000US060855067031,600,90,0,12,0,12,0,12,600,90,100,65,500,102,20341
1341,1341,15000US060855067032,414,72,10,15,0,12,10,15,404,73,34,25,370,75,20342
1342,1342,15000US060855067033,294,69,56,49,38,45,18,20,238,62,78,45,160,58,20343
1343,1343,15000US060855068011,726,115,0,12,0,12,0,12,726,115,129,72,597,112,20344
1344,1344,15000US060855068012,574,98,0,12,0,12,0,12,574,98,96,72,478,94,20345
1345,1345,15000US060855068013,541,95,0,12,0,12,0,12,541,95,110,62,431,103,20346
1346,1346,15000US060855068014,331,72,0,12,0,12,0,12,331,72,53,39,278,75,20347
1347,1347,15000US060855068021,523,70,0,12,0,12,0,12,523,70,129,49,394,78,20348
1348,1348,15000US060855068022,501,85,0,12,0,12,0,12,501,85,70,43,431,89,20349
1349,1349,15000US060855068023,320,87,6,10,0,12,6,10,314,88,88,70,226,72,20350
1350,1350,15000US060855068024,278,44,17,26,0,12,17,26,261,48,35,28,226,55,20351
1351,1351,15000US060855068025,313,53,0,12,0,12,0,12,313,53,41,33,272,53,20352
1352,1352,15000US060855068031,543,90,0,12,0,12,0,12,543,90,150,76,393,94,20353
1353,1353,15000US060855068032,486,77,0,12,0,12,0,12,486,77,104,60,382,86,20354
1354,1354,15000US060855068033,1041,147,0,12,0,12,0,12,1041,147,196,114,845,164,20355
1355,1355,15000US060855068034,293,99,0,12,0,12,0,12,293,99,28,32,265,96,20356
1356,1356,15000US060855068041,281,53,0,12,0,12,0,12,281,53,41,29,240,56,20357
1357,1357,15000US060855068042,415,57,0,12,0,12,0,12,415,57,95,48,320,70,20358
1358,1358,15000US060855068043,380,71,0,12,0,12,0,12,380,71,71,38,309,75,20359
1359,1359,15000US060855068044,202,45,0,12,0,12,0,12,202,45,27,26,175,48,20360
1360,1360,15000US060855069001,439,108,0,12,0,12,0,12,439,108,68,53,371,114,20361
1361,1361,15000US060855069002,643,79,17,26,0,12,17,26,626,83,131,83,495,96,20362
1362,1362,15000US060855069003,670,113,0,12,0,12,0,12,670,113,166,79,504,114,20363
1363,1363,15000US060855069004,882,110,0,12,0,12,0,12,882,110,299,99,583,118,20364
1364,1364,15000US060855070011,1095,155,0,12,0,12,0,12,1095,155,117,97,978,162,20365
1365,1365,15000US060855070012,1013,144,0,12,0,12,0,12,1013,144,183,79,830,146,20366
1366,1366,15000US060855070013,596,125,0,12,0,12,0,12,596,125,20,23,576,128,20367
1367,1367,15000US060855070014,273,84,0,12,0,12,0,12,273,84,34,33,239,88,20368
1368,1368,15000US060855070021,665,65,0,12,0,12,0,12,665,65,103,48,562,72,20369
1369,1369,15000US060855070022,340,56,32,42,0,12,32,42,308,52,65,33,243,56,20370
1370,1370,15000US060855071001,446,68,0,12,0,12,0,12,446,68,60,37,386,78,20371
1371,1371,15000US060855071002,836,86,47,28,9,13,38,27,789,80,106,71,683,90,20372
1372,1372,15000US060855072031,616,76,25,41,25,41,0,12,591,82,81,49,510,82,20373
1373,1373,15000US060855072032,550,77,0,12,0,12,0,12,550,77,111,46,439,91,20374
1374,1374,15000US060855072051,230,53,0,12,0,12,0,12,230,53,62,52,168,43,20375
1375,1375,15000US060855072052,694,67,0,12,0,12,0,12,694,67,173,49,521,72,20376
1376,1376,15000US060855072053,577,67,0,12,0,12,0,12,577,67,119,50,458,65,20377
1377,1377,15000US060855072054,324,54,0,12,0,12,0,12,324,54,76,45,248,66,20378
1378,1378,15000US060855072061,573,58,0,12,0,12,0,12,573,58,91,41,482,68,20379
1379,1379,15000US060855072062,482,47,11,12,11,12,0,12,471,48,87,33,384,47,20380
1380,1380,15000US060855073011,253,72,0,12,0,12,0,12,253,72,82,52,171,70,20381
1381,1381,15000US060855073012,425,97,0,12,0,12,0,12,425,97,98,65,327,103,20382
1382,1382,15000US060855073013,342,85,0,12,0,12,0,12,342,85,26,23,316,87,20383
1383,1383,15000US060855073014,298,62,0,12,0,12,0,12,298,62,29,33,269,75,20384
1384,1384,15000US060855073015,453,109,0,12,0,12,0,12,453,109,11,19,442,106,20385
1385,1385,15000US060855073016,643,123,0,12,0,12,0,12,643,123,295,116,348,122,20386
1386,1386,15000US060855073021,661,68,28,40,0,12,28,40,633,75,69,43,564,83,20387
1387,1387,15000US060855073022,370,60,0,12,0,12,0,12,370,60,50,42,320,63,20388
1388,1388,15000US060855074011,431,42,9,14,0,12,9,14,422,44,57,27,365,52,20389
1389,1389,15000US060855074012,387,54,0,12,0,12,0,12,387,54,50,35,337,60,20390
1390,1390,15000US060855074013,444,47,0,12,0,12,0,12,444,47,69,35,375,56,20391
1391,1391,15000US060855074014,342,43,0,12,0,12,0,12,342,43,50,29,292,48,20392
1392,1392,15000US060855074015,256,38,0,12,0,12,0,12,256,38,19,20,237,43,20393
1393,1393,15000US060855074021,570,85,9,14,0,12,9,14,561,86,158,57,403,82,20394
1394,1394,15000US060855074022,390,54,0,12,0,12,0,12,390,54,100,46,290,61,20395
1395,1395,15000US060855074023,493,83,0,12,0,12,0,12,493,83,73,38,420,86,20396
1396,1396,15000US060855075001,721,104,0,12,0,12,0,12,721,104,75,44,646,106,20397
1397,1397,15000US060855075002,448,63,0,12,0,12,0,12,448,63,23,26,425,62,20398
1398,1398,15000US060855075003,414,62,0,12,0,12,0,12,414,62,68,42,346,76,20399
1399,1399,15000US060855075004,445,65,0,12,0,12,0,12,445,65,150,71,295,67,20400
1400,1400,15000US060855076001,226,61,0,12,0,12,0,12,226,61,39,40,187,75,20401
1401,1401,15000US060855076002,410,66,0,12,0,12,0,12,410,66,71,58,339,66,20402
1402,1402,15000US060855076003,581,71,13,21,13,21,0,12,568,74,75,47,493,90,20403
1403,1403,15000US060855076004,745,95,0,12,0,12,0,12,745,95,47,37,698,99,20404
1404,1404,15000US060855077011,360,51,0,12,0,12,0,12,360,51,68,47,292,55,20405
1405,1405,15000US060855077012,594,81,0,12,0,12,0,12,594,81,69,63,525,74,20406
1406,1406,15000US060855077013,418,60,0,12,0,12,0,12,418,60,132,48,286,66,20407
1407,1407,15000US060855077021,676,97,0,12,0,12,0,12,676,97,71,59,605,105,20408
1408,1408,15000US060855077022,552,85,0,12,0,12,0,12,552,85,113,56,439,96,20409
1409,1409,15000US060855077023,830,106,0,12,0,12,0,12,830,106,87,62,743,112,20410
1410,1410,15000US060855077031,370,80,0,12,0,12,0,12,370,80,41,39,329,87,20411
1411,1411,15000US060855077032,824,100,0,12,0,12,0,12,824,100,184,79,640,104,20412
1412,1412,15000US060855077033,706,109,0,12,0,12,0,12,706,109,123,64,583,117,20413
1413,1413,15000US060855077034,375,90,0,12,0,12,0,12,375,90,92,92,283,76,20414
1414,1414,15000US060855077035,418,64,0,12,0,12,0,12,418,64,28,30,390,68,20415
1415,1415,15000US060855078051,1257,112,15,24,0,12,15,24,1242,117,146,79,1096,123,20416
1416,1416,15000US060855078052,496,94,16,25,0,12,16,25,480,95,83,72,397,89,20417
1417,1417,15000US060855078053,450,76,0,12,0,12,0,12,450,76,108,71,342,89,20418
1418,1418,15000US060855078061,275,48,0,12,0,12,0,12,275,48,72,36,203,50,20419
1419,1419,15000US060855078062,644,95,9,14,0,12,9,14,635,94,37,29,598,95,20420
1420,1420,15000US060855078063,892,96,25,23,0,12,25,23,867,94,80,40,787,94,20421
1421,1421,15000US060855078071,459,54,0,12,0,12,0,12,459,54,76,41,383,62,20422
1422,1422,15000US060855078072,593,55,0,12,0,12,0,12,593,55,82,37,511,59,20423
1423,1423,15000US060855078081,316,54,0,12,0,12,0,12,316,54,20,21,296,58,20424
1424,1424,15000US060855078082,379,58,0,12,0,12,0,12,379,58,28,25,351,60,20425
1425,1425,15000US060855078083,459,73,0,12,0,12,0,12,459,73,30,28,429,77,20426
1426,1426,15000US060855078084,619,53,8,12,0,12,8,12,611,54,36,28,575,62,20427
1427,1427,15000US060855079031,542,52,0,12,0,12,0,12,542,52,52,36,490,63,20428
1428,1428,15000US060855079032,1084,50,0,12,0,12,0,12,1084,50,208,58,876,65,20429
1429,1429,15000US060855079041,609,52,0,12,0,12,0,12,609,52,100,46,509,65,20430
1430,1430,15000US060855079042,489,47,0,12,0,12,0,12,489,47,73,40,416,54,20431
1431,1431,15000US060855079051,667,126,64,75,0,12,64,75,603,145,45,42,558,143,20432
1432,1432,15000US060855079052,739,112,0,12,0,12,0,12,739,112,130,78,609,118,20433
1433,1433,15000US060855079053,746,130,9,17,0,12,9,17,737,131,29,35,708,134,20434
1434,1434,15000US060855079061,428,53,8,15,0,12,8,15,420,51,103,56,317,57,20435
1435,1435,15000US060855079062,405,52,0,12,0,12,0,12,405,52,54,40,351,58,20436
1436,1436,15000US060855079063,292,42,0,12,0,12,0,12,292,42,25,23,267,47,20437
1437,1437,15000US060855079064,286,52,0,12,0,12,0,12,286,52,46,38,240,58,20438
1438,1438,15000US060855080011,784,132,14,23,0,12,14,23,770,133,98,57,672,137,20439
1439,1439,15000US060855080012,369,94,0,12,0,12,0,12,369,94,38,38,331,109,20440
1440,1440,15000US060855080013,1428,149,8,15,0,12,8,15,1420,149,265,109,1155,155,20441
1441,1441,15000US060855080014,277,72,0,12,0,12,0,12,277,72,43,30,234,67,20442
1442,1442,15000US060855080031,517,37,4,7,0,12,4,7,513,37,85,32,428,49,20443
1443,1443,15000US060855080032,253,33,11,19,0,12,11,19,242,33,44,23,198,34,20444
1444,1444,15000US060855080041,921,107,11,17,0,12,11,17,910,108,179,105,731,116,20445
1445,1445,15000US060855080042,422,90,0,12,0,12,0,12,422,90,52,49,370,95,20446
1446,1446,15000US060855080043,867,101,36,43,36,43,0,12,831,100,40,45,791,109,20447
1447,1447,15000US060855081011,655,74,0,12,0,12,0,12,655,74,72,55,583,85,20448
1448,1448,15000US060855081012,690,101,0,12,0,12,0,12,690,101,67,52,623,112,20449
1449,1449,15000US060855081013,982,122,12,20,12,20,0,12,970,125,77,58,893,121,20450
1450,1450,15000US060855081021,1193,79,0,12,0,12,0,12,1193,79,42,27,1151,84,20451
1451,1451,15000US060855082021,419,105,21,33,21,33,0,12,398,103,140,107,258,90,20452
1452,1452,15000US060855082022,848,149,17,27,17,27,0,12,831,148,100,54,731,145,20453
1453,1453,15000US060855082023,331,70,20,33,0,12,20,33,311,66,41,40,270,76,20454
1454,1454,15000US060855082024,585,129,0,12,0,12,0,12,585,129,27,33,558,129,20455
1455,1455,15000US060855082025,589,99,0,12,0,12,0,12,589,99,87,61,502,107,20456
1456,1456,15000US060855082031,431,62,0,12,0,12,0,12,431,62,86,40,345,67,20457
1457,1457,15000US060855082032,595,72,0,12,0,12,0,12,595,72,68,36,527,79,20458
1458,1458,15000US060855082033,771,76,0,12,0,12,0,12,771,76,106,52,665,82,20459
1459,1459,15000US060855082041,634,91,0,12,0,12,0,12,634,91,108,76,526,81,20460
1460,1460,15000US060855082042,348,44,0,12,0,12,0,12,348,44,42,28,306,50,20461
1461,1461,15000US060855082043,499,60,12,20,0,12,12,20,487,58,66,39,421,66,20462
1462,1462,15000US060855083011,520,53,0,12,0,12,0,12,520,53,34,29,486,61,20463
1463,1463,15000US060855083012,421,49,0,12,0,12,0,12,421,49,118,46,303,56,20464
1464,1464,15000US060855083013,626,63,0,12,0,12,0,12,626,63,74,38,552,72,20465
1465,1465,15000US060855083031,505,37,0,12,0,12,0,12,505,37,84,34,421,42,20466
1466,1466,15000US060855083032,419,45,7,11,0,12,7,11,412,43,74,28,338,47,20467
1467,1467,15000US060855083041,547,137,0,12,0,12,0,12,547,137,96,59,451,144,20468
1468,1468,15000US060855083042,250,68,0,12,0,12,0,12,250,68,28,32,222,65,20469
1469,1469,15000US060855083043,360,64,0,12,0,12,0,12,360,64,53,44,307,65,20470
1470,1470,15000US060855083044,756,117,19,31,0,12,19,31,737,119,113,59,624,134,20471
1471,1471,15000US060855083045,1145,168,51,63,0,12,51,63,1094,183,116,87,978,182,20472
1472,1472,15000US060855084011,271,88,0,12,0,12,0,12,271,88,57,59,214,92,20473
1473,1473,15000US060855084012,373,63,0,12,0,12,0,12,373,63,66,40,307,75,20474
1474,1474,15000US060855084013,405,90,0,12,0,12,0,12,405,90,30,23,375,95,20475
1475,1475,15000US060855084014,282,54,0,12,0,12,0,12,282,54,62,41,220,56,20476
1476,1476,15000US060855084015,443,75,0,12,0,12,0,12,443,75,21,25,422,82,20477
1477,1477,15000US060855084016,576,100,0,12,0,12,0,12,576,100,145,72,431,103,20478
1478,1478,15000US060855084031,288,42,0,12,0,12,0,12,288,42,57,26,231,43,20479
1479,1479,15000US060855084032,409,63,0,12,0,12,0,12,409,63,52,27,357,67,20480
1480,1480,15000US060855084033,381,50,0,12,0,12,0,12,381,50,24,18,357,52,20481
1481,1481,15000US060855084041,1271,109,30,33,16,25,14,21,1241,112,121,67,1120,118,20482
1482,1482,15000US060855084042,550,74,0,12,0,12,0,12,550,74,147,65,403,88,20483
1483,1483,15000US060855084043,507,67,13,21,13,21,0,12,494,69,115,68,379,84,20484
1484,1484,15000US060855085031,777,139,0,12,0,12,0,12,777,139,86,74,691,121,20485
1485,1485,15000US060855085032,586,87,0,12,0,12,0,12,586,87,42,39,544,94,20486
1486,1486,15000US060855085033,1267,143,17,26,0,12,17,26,1250,143,157,57,1093,146,20487
1487,1487,15000US060855085041,1178,159,32,38,0,12,32,38,1146,163,222,95,924,162,20488
1488,1488,15000US060855085042,837,140,52,47,14,23,38,41,785,141,135,76,650,138,20489
1489,1489,15000US060855085043,494,109,0,12,0,12,0,12,494,109,29,32,465,118,20490
1490,1490,15000US060855085044,887,141,60,67,40,64,20,37,827,141,27,29,800,143,20491
1491,1491,15000US060855085051,471,59,7,10,7,10,0,12,464,60,69,30,395,68,20492
1492,1492,15000US060855085052,457,58,0,12,0,12,0,12,457,58,91,43,366,61,20493
1493,1493,15000US060855085053,986,104,10,14,0,12,10,14,976,103,125,77,851,106,20494
1494,1494,15000US060855085071,657,70,19,23,9,16,10,16,638,77,31,31,607,88,20495
1495,1495,15000US060855085072,686,80,54,43,10,17,44,40,632,83,44,47,588,86,20496
1496,1496,15000US060855085081,284,51,0,12,0,12,0,12,284,51,45,24,239,54,20497
1497,1497,15000US060855085082,532,86,0,12,0,12,0,12,532,86,67,55,465,88,20498
1498,1498,15000US060855085083,909,135,27,31,27,31,0,12,882,133,172,79,710,136,20499
1499,1499,15000US060855085084,304,90,0,12,0,12,0,12,304,90,65,49,239,93,20500
1500,1500,15000US060855086011,302,66,0,12,0,12,0,12,302,66,30,23,272,69,20501
1501,1501,15000US060855086012,547,61,10,15,10,15,0,12,537,61,65,28,472,64,20502
1502,1502,15000US060855086013,506,76,33,51,33,51,0,12,473,75,84,50,389,73,20503
1503,1503,15000US060855086021,1239,119,38,36,26,31,12,19,1201,121,266,79,935,126,20504
1504,1504,15000US060855086022,408,70,15,24,15,24,0,12,393,69,51,36,342,69,20505
1505,1505,15000US060855086023,369,90,0,12,0,12,0,12,369,90,42,32,327,89,20506
1506,1506,15000US060855087031,396,91,0,12,0,12,0,12,396,91,46,43,350,90,20507
1507,1507,15000US060855087032,731,124,0,12,0,12,0,12,731,124,18,28,713,133,20508
1508,1508,15000US060855087033,569,103,0,12,0,12,0,12,569,103,74,51,495,108,20509
1509,1509,15000US060855087034,434,96,50,37,34,37,16,27,384,96,54,60,330,81,20510
1510,1510,15000US060855087035,1126,164,13,21,13,21,0,12,1113,166,99,67,1014,174,20511
1511,1511,15000US060855087041,973,138,71,57,0,12,71,57,902,157,52,45,850,154,20512
1512,1512,15000US060855087042,1128,154,62,66,27,32,35,56,1066,152,150,74,916,146,20513
1513,1513,15000US060855087043,502,114,0,12,0,12,0,12,502,114,35,34,467,117,20514
1514,1514,15000US060855088001,960,93,39,43,29,40,10,17,921,92,70,38,851,93,20515
1515,1515,15000US060855088002,500,87,65,47,12,18,53,44,435,90,83,50,352,86,20516
1516,1516,15000US060855089001,1053,100,82,59,40,42,42,40,971,104,63,36,908,102,20517
1517,1517,15000US060855089002,412,73,0,12,0,12,0,12,412,73,80,43,332,73,20518
1518,1518,15000US060855089003,235,43,14,17,5,8,9,14,221,45,72,35,149,44,20519
1519,1519,15000US060855090001,681,159,106,116,0,12,106,116,575,137,73,58,502,135,20520
1520,1520,15000US060855090002,561,144,49,80,0,12,49,80,512,152,121,86,391,145,20521
1521,1521,15000US060855090003,837,170,54,50,39,44,15,24,783,169,53,43,730,169,20522
1522,1522,15000US060855090004,461,96,18,30,0,12,18,30,443,105,85,62,358,118,20523
1523,1523,15000US060855091021,1030,113,0,12,0,12,0,12,1030,113,153,72,877,126,20524
1524,1524,15000US060855091022,1244,140,27,37,27,37,0,12,1217,140,66,82,1151,152,20525
1525,1525,15000US060855091051,1044,158,82,99,11,18,71,101,962,166,206,99,756,165,20526
1526,1526,15000US060855091052,784,150,50,64,9,16,41,63,734,154,49,42,685,160,20527
1527,1527,15000US060855091053,593,113,0,12,0,12,0,12,593,113,56,45,537,120,20528
1528,1528,15000US060855091054,636,136,0,12,0,12,0,12,636,136,15,23,621,142,20529
1529,1529,15000US060855091061,537,82,46,49,36,48,10,16,491,73,71,33,420,79,20530
1530,1530,15000US060855091062,391,80,0,12,0,12,0,12,391,80,90,44,301,73,20531
1531,1531,15000US060855091063,765,102,64,60,0,12,64,60,701,100,51,31,650,96,20532
1532,1532,15000US060855091071,829,133,40,40,12,19,28,33,789,132,134,74,655,123,20533
1533,1533,15000US060855091072,1117,142,96,62,8,12,88,62,1021,138,37,29,984,144,20534
1534,1534,15000US060855091081,491,99,45,42,10,15,35,40,446,91,26,25,420,93,20535
1535,1535,15000US060855091082,440,88,0,12,0,12,0,12,440,88,30,27,410,90,20536
1536,1536,15000US060855091083,479,91,18,20,0,12,18,20,461,93,42,42,419,91,20537
1537,1537,15000US060855091084,557,85,29,27,9,15,20,23,528,89,110,48,418,92,20538
1538,1538,15000US060855091091,1288,83,0,12,0,12,0,12,1288,83,54,27,1234,89,20539
1539,1539,15000US060855091092,655,67,0,12,0,12,0,12,655,67,27,24,628,73,20540
1540,1540,15000US060855092011,598,123,0,12,0,12,0,12,598,123,47,46,551,124,20541
1541,1541,15000US060855092012,534,115,12,18,12,18,0,12,522,115,31,32,491,117,20542
1542,1542,15000US060855092013,673,156,0,12,0,12,0,12,673,156,11,18,662,160,20543
1543,1543,15000US060855092014,532,137,0,12,0,12,0,12,532,137,124,70,408,138,20544
1544,1544,15000US060855092021,851,89,29,31,29,31,0,12,822,86,181,54,641,88,20545
1545,1545,15000US060855092022,338,56,7,11,0,12,7,11,331,56,74,59,257,64,20546
1546,1546,15000US060855092023,485,75,0,12,0,12,0,12,485,75,60,52,425,77,20547
1547,1547,15000US060855092024,211,39,9,14,9,14,0,12,202,40,32,21,170,43,20548
1548,1548,15000US060855093021,1222,44,8,13,0,12,8,13,1214,46,201,73,1013,85,20549
1549,1549,15000US060855093031,504,79,13,20,0,12,13,20,491,80,79,46,412,75,20550
1550,1550,15000US060855093032,419,52,40,28,0,12,40,28,379,53,54,33,325,56,20551
1551,1551,15000US060855093033,394,84,31,47,0,12,31,47,363,79,79,49,284,81,20552
1552,1552,15000US060855093034,426,83,26,20,17,20,9,14,400,84,86,39,314,79,20553
1553,1553,15000US060855093041,557,94,59,53,0,12,59,53,498,106,89,44,409,103,20554
1554,1554,15000US060855093042,800,78,4,8,0,12,4,8,796,78,67,35,729,83,20555
1555,1555,15000US060855094011,780,81,50,30,35,27,15,12,730,84,72,40,658,89,20556
1556,1556,15000US060855094012,291,66,0,12,0,12,0,12,291,66,55,36,236,64,20557
1557,1557,15000US060855094013,686,83,8,13,0,12,8,13,678,82,53,43,625,87,20558
1558,1558,15000US060855094031,914,146,95,73,0,12,95,73,819,138,126,100,693,145,20559
1559,1559,15000US060855094032,1138,161,52,50,15,24,37,45,1086,160,80,67,1006,151,20560
1560,1560,15000US060855094041,847,119,0,12,0,12,0,12,847,119,83,59,764,111,20561
1561,1561,15000US060855094042,448,140,71,87,0,12,71,87,377,119,63,74,314,116,20562
1562,1562,15000US060855094043,940,142,17,28,17,28,0,12,923,145,193,132,730,142,20563
1563,1563,15000US060855094044,448,115,0,12,0,12,0,12,448,115,80,57,368,112,20564
1564,1564,15000US060855095001,1014,165,34,38,34,38,0,12,980,177,87,71,893,154,20565
1565,1565,15000US060855095002,646,122,0,12,0,12,0,12,646,122,16,26,630,120,20566
1566,1566,15000US060855095003,580,110,33,37,19,30,14,22,547,115,27,33,520,115,20567
1567,1567,15000US060855096001,936,89,27,27,0,12,27,27,909,90,92,67,817,95,20568
1568,1568,15000US060855096002,547,81,27,42,27,42,0,12,520,82,40,28,480,78,20569
1569,1569,15000US060855097001,422,53,0,12,0,12,0,12,422,53,42,29,380,55,20570
1570,1570,15000US060855097002,508,80,26,42,0,12,26,42,482,73,37,50,445,64,20571
1571,1571,15000US060855097003,478,54,0,12,0,12,0,12,478,54,48,29,430,57,20572
1572,1572,15000US060855098011,782,131,65,71,0,12,65,71,717,130,99,77,618,140,20573
1573,1573,15000US060855098012,298,61,0,12,0,12,0,12,298,61,13,22,285,63,20574
1574,1574,15000US060855098013,575,92,0,12,0,12,0,12,575,92,47,44,528,98,20575
1575,1575,15000US060855098014,517,77,12,19,12,19,0,12,505,78,81,56,424,82,20576
1576,1576,15000US060855098021,659,68,18,27,2,6,16,26,641,69,35,25,606,71,20577
1577,1577,15000US060855098022,472,58,0,12,0,12,0,12,472,58,55,40,417,66,20578
1578,1578,15000US060855099011,339,33,4,8,0,12,4,8,335,33,36,21,299,39,20579
1579,1579,15000US060855099012,350,39,0,12,0,12,0,12,350,39,24,15,326,42,20580
1580,1580,15000US060855099021,977,81,9,13,9,13,0,12,968,80,264,82,704,104,20581
1581,1581,15000US060855099022,367,53,0,12,0,12,0,12,367,53,38,25,329,54,20582
1582,1582,15000US060855099023,495,63,0,12,0,12,0,12,495,63,91,44,404,73,20583
1583,1583,15000US060855100011,317,49,0,12,0,12,0,12,317,49,61,61,256,65,20584
1584,1584,15000US060855100012,529,74,0,12,0,12,0,12,529,74,75,56,454,90,20585
1585,1585,15000US060855100013,377,77,0,12,0,12,0,12,377,77,27,31,350,85,20586
1586,1586,15000US060855100014,271,71,0,12,0,12,0,12,271,71,18,29,253,76,20587
1587,1587,15000US060855100015,293,73,0,12,0,12,0,12,293,73,61,34,232,79,20588
1588,1588,15000US060855100016,276,65,0,12,0,12,0,12,276,65,29,23,247,68,20589
1589,1589,15000US060855100021,539,56,0,12,0,12,0,12,539,56,77,38,462,71,20590
1590,1590,15000US060855100022,371,45,0,12,0,12,0,12,371,45,75,37,296,57,20591
1591,1591,15000US060855100023,381,42,8,13,0,12,8,13,373,44,21,19,352,46,20592
1592,1592,15000US060855101001,566,52,0,12,0,12,0,12,566,52,132,66,434,66,20593
1593,1593,15000US060855101002,151,35,0,12,0,12,0,12,151,35,15,12,136,35,20594
1594,1594,15000US060855101003,364,50,0,12,0,12,0,12,364,50,48,48,316,51,20595
1595,1595,15000US060855102001,566,61,0,12,0,12,0,12,566,61,52,31,514,68,20596
1596,1596,15000US060855102002,335,48,0,12,0,12,0,12,335,48,61,38,274,50,20597
1597,1597,15000US060855102003,539,54,0,12,0,12,0,12,539,54,126,54,413,71,20598
1598,1598,15000US060855103001,564,64,9,14,0,12,9,14,555,65,54,36,501,70,20599
1599,1599,15000US060855103002,717,73,0,12,0,12,0,12,717,73,81,42,636,73,20600
1600,1600,15000US060855103003,435,53,0,12,0,12,0,12,435,53,52,45,383,53,20601
1601,1601,15000US060855104001,543,67,8,13,0,12,8,13,535,67,83,44,452,72,20602
1602,1602,15000US060855104002,248,37,0,12,0,12,0,12,248,37,31,28,217,34,20603
1603,1603,15000US060855104003,374,59,0,12,0,12,0,12,374,59,34,30,340,63,20604
1604,1604,15000US060855105001,465,81,13,16,6,9,7,12,452,83,39,28,413,81,20605
1605,1605,15000US060855105002,637,64,0,12,0,12,0,12,637,64,177,59,460,57,20606
1606,1606,15000US060855105003,789,74,9,14,0,12,9,14,780,72,95,47,685,75,20607
1607,1607,15000US060855106001,257,59,0,12,0,12,0,12,257,59,31,36,226,68,20608
1608,1608,15000US060855106002,957,131,17,27,0,12,17,27,940,134,113,77,827,133,20609
1609,1609,15000US060855106003,660,115,0,12,0,12,0,12,660,115,148,84,512,122,20610
1610,1610,15000US060855106004,476,104,0,12,0,12,0,12,476,104,94,67,382,104,20611
1611,1611,15000US060855107001,271,61,0,12,0,12,0,12,271,61,21,25,250,63,20612
1612,1612,15000US060855107002,862,131,51,80,0,12,51,80,811,133,121,63,690,123,20613
1613,1613,15000US060855107003,913,115,0,12,0,12,0,12,913,115,70,45,843,123,20614
1614,1614,15000US060855108011,503,92,0,12,0,12,0,12,503,92,39,37,464,104,20615
1615,1615,15000US060855108012,688,90,0,12,0,12,0,12,688,90,51,46,637,88,20616
1616,1616,15000US060855108013,1019,116,14,23,0,12,14,23,1005,120,327,129,678,99,20617
1617,1617,15000US060855108021,309,37,0,12,0,12,0,12,309,37,48,30,261,41,20618
1618,1618,15000US060855108022,374,42,18,17,14,15,4,7,356,42,86,35,270,47,20619
1619,1619,15000US060855108031,529,78,34,43,25,40,9,14,495,84,107,61,388,89,20620
1620,1620,15000US060855108032,468,64,0,12,0,12,0,12,468,64,79,60,389,78,20621
1621,1621,15000US060855109001,663,110,0,12,0,12,0,12,663,110,31,36,632,113,20622
1622,1622,15000US060855109002,789,127,25,29,14,22,11,19,764,128,126,99,638,121,20623
1623,1623,15000US060855109003,588,97,0,12,0,12,0,12,588,97,50,45,538,101,20624
1624,1624,15000US060855110001,641,95,0,12,0,12,0,12,641,95,105,85,536,92,20625
1625,1625,15000US060855110002,592,113,16,25,0,12,16,25,576,113,31,31,545,113,20626
1626,1626,15000US060855110003,221,48,0,12,0,12,0,12,221,48,27,30,194,53,20627
1627,1627,15000US060855110004,511,73,22,25,10,16,12,19,489,81,47,56,442,83,20628
1628,1628,15000US060855110005,484,71,0,12,0,12,0,12,484,71,27,30,457,78,20629
1629,1629,15000US060855111001,480,69,0,12,0,12,0,12,480,69,64,36,416,74,20630
1630,1630,15000US060855111002,536,69,0,12,0,12,0,12,536,69,39,29,497,71,20631
1631,1631,15000US060855111003,460,55,0,12,0,12,0,12,460,55,60,37,400,68,20632
1632,1632,15000US060855111004,370,52,0,12,0,12,0,12,370,52,49,28,321,56,20633
1633,1633,15000US060855112001,533,75,15,22,0,12,15,22,518,72,79,54,439,75,20634
1634,1634,15000US060855112002,500,62,18,26,0,12,18,26,482,60,55,31,427,65,20635
1635,1635,15000US060855112003,300,47,0,12,0,12,0,12,300,47,67,42,233,60,20636
1636,1636,15000US060855112004,337,72,0,12,0,12,0,12,337,72,52,30,285,82,20637
1637,1637,15000US060855113011,1332,99,42,49,0,12,42,49,1290,112,217,60,1073,126,20638
1638,1638,15000US060855113012,469,68,8,13,0,12,8,13,461,69,53,35,408,67,20639
1639,1639,15000US060855113021,811,113,0,12,0,12,0,12,811,113,254,88,557,130,20640
1640,1640,15000US060855113022,300,121,16,25,0,12,16,25,284,122,0,12,284,122,20641
1641,1641,15000US060855113023,1025,150,39,53,0,12,39,53,986,152,80,52,906,156,20642
1642,1642,15000US060855114001,332,55,0,12,0,12,0,12,332,55,17,19,315,58,20643
1643,1643,15000US060855114002,406,61,27,33,0,12,27,33,379,59,53,42,326,62,20644
1644,1644,15000US060855114003,199,34,0,12,0,12,0,12,199,34,27,24,172,42,20645
1645,1645,15000US060855114004,398,62,0,12,0,12,0,12,398,62,46,23,352,63,20646
1646,1646,15000US060855115001,394,98,0,12,0,12,0,12,394,98,43,44,351,95,20647
1647,1647,15000US060855115002,838,141,22,26,22,26,0,12,816,143,123,86,693,125,20648
1648,1648,15000US060855115003,908,115,0,12,0,12,0,12,908,115,48,40,860,129,20649
1649,1649,15000US060855115004,336,82,0,12,0,12,0,12,336,82,83,57,253,89,20650
1650,1650,15000US060855115005,567,104,0,12,0,12,0,12,567,104,54,50,513,108,20651
1651,1651,15000US060855116081,16,17,0,12,0,12,0,12,16,17,12,20,4,6,20652
1652,1652,15000US060855116082,77,20,16,19,0,12,16,19,61,19,5,7,56,19,20653
1653,1653,15000US060855116091,1714,80,13,19,13,19,0,12,1701,81,305,98,1396,104,20654
1654,1654,15000US060855117011,458,81,42,66,42,66,0,12,416,68,28,18,388,72,20655
1655,1655,15000US060855117012,745,81,0,12,0,12,0,12,745,81,72,37,673,85,20656
1656,1656,15000US060855117013,362,62,3,7,3,7,0,12,359,62,22,25,337,63,20657
1657,1657,15000US060855117021,657,49,0,12,0,12,0,12,657,49,108,30,549,50,20658
1658,1658,15000US060855117022,288,35,0,12,0,12,0,12,288,35,20,15,268,37,20659
1659,1659,15000US060855117041,830,98,0,12,0,12,0,12,830,98,153,63,677,97,20660
1660,1660,15000US060855117042,239,50,0,12,0,12,0,12,239,50,40,33,199,50,20661
1661,1661,15000US060855117043,654,89,0,12,0,12,0,12,654,89,95,44,559,94,20662
1662,1662,15000US060855117051,357,15,0,12,0,12,0,12,357,15,56,21,301,24,20663
1663,1663,15000US060855117071,1206,76,0,12,0,12,0,12,1206,76,223,70,983,85,20664
1664,1664,15000US060855118001,658,92,39,47,10,15,29,44,619,100,72,40,547,95,20665
1665,1665,15000US060855118002,412,88,5,8,0,12,5,8,407,87,33,29,374,88,20666
1666,1666,15000US060855118003,575,93,38,59,0,12,38,59,537,93,68,40,469,101,20667
1667,1667,15000US060855119051,1063,39,0,12,0,12,0,12,1063,39,220,74,843,84,20668
1668,1668,15000US060855119071,540,75,0,12,0,12,0,12,540,75,47,48,493,84,20669
1669,1669,15000US060855119072,804,78,0,12,0,12,0,12,804,78,130,59,674,85,20670
1670,1670,15000US060855119091,1006,112,0,12,0,12,0,12,1006,112,149,78,857,114,20671
1671,1671,15000US060855119092,790,92,0,12,0,12,0,12,790,92,100,72,690,89,20672
1672,1672,15000US060855119093,862,101,0,12,0,12,0,12,862,101,86,51,776,113,20673
1673,1673,15000US060855119101,356,47,0,12,0,12,0,12,356,47,87,43,269,56,20674
1674,1674,15000US060855119102,242,49,0,12,0,12,0,12,242,49,38,29,204,49,20675
1675,1675,15000US060855119103,453,48,0,12,0,12,0,12,453,48,82,46,371,60,20676
1676,1676,15000US060855119111,948,89,0,12,0,12,0,12,948,89,198,75,750,91,20677
1677,1677,15000US060855119112,372,72,0,12,0,12,0,12,372,72,96,50,276,87,20678
1678,1678,15000US060855119113,559,85,0,12,0,12,0,12,559,85,83,44,476,85,20679
1679,1679,15000US060855119121,672,67,0,12,0,12,0,12,672,67,134,48,538,76,20680
1680,1680,15000US060855119122,688,65,13,20,0,12,13,20,675,73,153,77,522,73,20681
1681,1681,15000US060855119123,388,52,5,8,0,12,5,8,383,52,80,47,303,58,20682
1682,1682,15000US060855119131,440,63,0,12,0,12,0,12,440,63,79,47,361,72,20683
1683,1683,15000US060855119132,554,78,0,12,0,12,0,12,554,78,102,48,452,81,20684
1684,1684,15000US060855119133,433,66,5,9,5,9,0,12,428,69,21,20,407,69,20685
1685,1685,15000US060855119141,413,60,0,12,0,12,0,12,413,60,44,33,369,64,20686
1686,1686,15000US060855119142,1014,70,0,12,0,12,0,12,1014,70,194,61,820,81,20687
1687,1687,15000US060855119143,491,61,0,12,0,12,0,12,491,61,161,54,330,65,20688
1688,1688,15000US060855119151,455,60,8,12,8,12,0,12,447,62,132,45,315,66,20689
1689,1689,15000US060855119152,820,91,192,81,68,53,124,61,628,119,148,61,480,104,20690
1690,1690,15000US060855119161,811,85,35,37,8,14,27,35,776,94,143,75,633,104,20691
1691,1691,15000US060855119162,885,79,5,8,5,8,0,12,880,81,111,52,769,84,20692
1692,1692,15000US060855120011,1034,131,9,13,9,13,0,12,1025,133,80,74,945,140,20693
1693,1693,15000US060855120012,533,108,0,12,0,12,0,12,533,108,57,54,476,106,20694
1694,1694,15000US060855120013,445,84,10,18,10,18,0,12,435,86,55,39,380,89,20695
1695,1695,15000US060855120051,549,119,11,18,11,18,0,12,538,120,35,34,503,125,20696
1696,1696,15000US060855120052,272,83,0,12,0,12,0,12,272,83,95,58,177,81,20697
1697,1697,15000US060855120053,256,59,24,30,24,30,0,12,232,58,94,58,138,67,20698
1698,1698,15000US060855120054,463,112,41,56,0,12,41,56,422,101,173,88,249,102,20699
1699,1699,15000US060855120055,677,150,50,57,13,20,37,53,627,166,156,82,471,179,20700
1700,1700,15000US060855120171,830,128,118,96,15,29,103,94,712,125,111,61,601,124,20701
1701,1701,15000US060855120172,603,112,145,102,40,62,105,89,458,102,274,107,184,105,20702
1702,1702,15000US060855120173,780,104,133,76,31,35,102,80,647,117,245,122,402,105,20703
1703,1703,15000US060855120191,299,51,0,12,0,12,0,12,299,51,83,40,216,51,20704
1704,1704,15000US060855120192,720,76,40,46,8,13,32,45,680,76,85,58,595,81,20705
1705,1705,15000US060855120193,544,71,33,30,8,14,25,25,511,77,89,47,422,75,20706
1706,1706,15000US060855120201,238,89,22,36,22,36,0,12,216,86,40,36,176,92,20707
1707,1707,15000US060855120202,725,142,0,12,0,12,0,12,725,142,159,83,566,142,20708
1708,1708,15000US060855120203,1598,161,31,35,0,12,31,35,1567,167,148,101,1419,176,20709
1709,1709,15000US060855120211,388,91,0,12,0,12,0,12,388,91,56,41,332,91,20710
1710,1710,15000US060855120212,622,117,13,20,0,12,13,20,609,115,46,32,563,119,20711
1711,1711,15000US060855120213,512,97,0,12,0,12,0,12,512,97,73,48,439,103,20712
1712,1712,15000US060855120214,525,127,30,36,19,29,11,20,495,135,30,31,465,138,20713
1713,1713,15000US060855120221,349,72,16,17,9,12,7,11,333,75,72,42,261,76,20714
1714,1714,15000US060855120222,755,104,68,42,52,39,16,18,687,109,257,83,430,85,20715
1715,1715,15000US060855120223,784,96,52,58,0,12,52,58,732,98,132,66,600,111,20716
1716,1716,15000US060855120231,754,99,0,12,0,12,0,12,754,99,176,77,578,100,20717
1717,1717,15000US060855120232,548,115,71,48,10,15,61,47,477,111,126,69,351,94,20718
1718,1718,15000US060855120233,722,116,77,53,27,25,50,46,645,106,210,104,435,110,20719
1719,1719,15000US060855120241,1250,106,201,82,83,52,118,63,1049,116,197,61,852,113,20720
1720,1720,15000US060855120242,385,71,1,7,1,7,0,12,384,72,46,35,338,77,20721
1721,1721,15000US060855120251,758,58,9,15,9,15,0,12,749,58,254,74,495,66,20722
1722,1722,15000US060855120252,321,57,0,12,0,12,0,12,321,57,29,26,292,59,20723
1723,1723,15000US060855120261,669,97,112,59,38,31,74,56,557,101,124,69,433,98,20724
1724,1724,15000US060855120262,643,84,31,23,12,18,19,20,612,91,114,54,498,101,20725
1725,1725,15000US060855120271,811,104,88,69,47,56,41,46,723,112,245,82,478,93,20726
1726,1726,15000US060855120272,766,88,31,32,13,22,18,21,735,91,151,70,584,104,20727
1727,1727,15000US060855120291,460,100,2,5,2,5,0,12,458,100,95,71,363,110,20728
1728,1728,15000US060855120292,880,147,15,25,15,25,0,12,865,153,78,57,787,159,20729
1729,1729,15000US060855120293,364,113,0,12,0,12,0,12,364,113,34,39,330,115,20730
1730,1730,15000US060855120294,768,151,27,39,0,12,27,39,741,151,160,123,581,151,20731
1731,1731,15000US060855120301,620,47,10,11,6,8,4,6,610,48,98,39,512,55,20732
1732,1732,15000US060855120302,373,45,5,7,5,7,0,12,368,46,58,34,310,47,20733
1733,1733,15000US060855120311,226,62,4,8,4,8,0,12,222,63,81,59,141,48,20734
1734,1734,15000US060855120312,398,53,9,13,9,13,0,12,389,56,98,43,291,64,20735
1735,1735,15000US060855120313,427,64,10,16,10,16,0,12,417,65,36,29,381,75,20736
1736,1736,15000US060855120314,318,63,10,17,10,17,0,12,308,64,88,65,220,52,20737
1737,1737,15000US060855120321,452,58,8,15,8,15,0,12,444,59,66,31,378,65,20738
1738,1738,15000US060855120322,264,48,0,12,0,12,0,12,264,48,41,36,223,46,20739
1739,1739,15000US060855120323,290,53,9,15,9,15,0,12,281,53,114,52,167,52,20740
1740,1740,15000US060855120331,407,61,16,18,16,18,0,12,391,64,50,36,341,67,20741
1741,1741,15000US060855120332,763,109,82,74,38,58,44,49,681,103,127,65,554,104,20742
1742,1742,15000US060855120333,399,59,29,42,0,12,29,42,370,62,80,44,290,60,20743
1743,1743,15000US060855120334,464,76,18,27,0,12,18,27,446,80,116,51,330,99,20744
1744,1744,15000US060855120341,819,64,57,35,45,34,12,17,762,80,166,57,596,85,20745
1745,1745,15000US060855120342,200,47,12,18,0,12,12,18,188,48,59,33,129,49,20746
1746,1746,15000US060855120351,676,72,24,23,15,17,9,15,652,75,161,60,491,82,20747
1747,1747,15000US060855120352,736,76,22,22,13,19,9,14,714,79,95,57,619,70,20748
1748,1748,15000US060855120361,1888,70,25,28,25,28,0,17,1863,77,156,58,1707,92,20749
1749,1749,15000US060855120371,586,55,42,23,20,16,22,17,544,61,84,32,460,57,20750
1750,1750,15000US060855120372,389,57,24,28,24,28,0,12,365,59,80,40,285,54,20751
1751,1751,15000US060855120381,1073,48,105,55,51,42,54,44,968,75,171,71,797,87,20752
1752,1752,15000US060855120391,471,92,34,40,0,12,34,40,437,90,134,60,303,93,20753
1753,1753,15000US060855120392,352,72,11,18,0,12,11,18,341,71,63,44,278,64,20754
1754,1754,15000US060855120393,516,78,2,6,0,12,2,6,514,79,124,72,390,80,20755
1755,1755,15000US060855120421,422,55,16,15,0,12,16,15,406,56,82,32,324,53,20756
1756,1756,15000US060855120422,446,51,34,28,6,9,28,26,412,58,125,53,287,65,20757
1757,1757,15000US060855120431,1070,111,305,104,88,56,217,89,765,128,195,77,570,113,20758
1758,1758,15000US060855120432,522,83,52,34,0,12,52,34,470,88,78,45,392,92,20759
1759,1759,15000US060855120451,665,78,47,35,11,17,36,32,618,85,112,46,506,91,20760
1760,1760,15000US060855120452,252,60,10,16,0,12,10,16,242,63,64,34,178,61,20761
1761,1761,15000US060855120453,263,51,0,12,0,12,0,12,263,51,45,26,218,52,20762
1762,1762,15000US060855120454,628,88,14,19,10,16,4,9,614,89,124,70,490,92,20763
1763,1763,15000US060855120471,781,91,57,55,0,12,57,55,724,80,145,62,579,98,20764
1764,1764,15000US060855120472,495,81,15,17,8,13,7,12,480,85,91,46,389,85,20765
1765,1765,15000US060855120473,432,71,9,14,9,14,0,12,423,71,72,41,351,71,20766
1766,1766,15000US060855120521,500,99,10,15,0,12,10,15,490,99,44,46,446,101,20767
1767,1767,15000US060855120522,803,110,18,20,18,20,0,12,785,113,166,59,619,117,20768
1768,1768,15000US060855120523,459,59,0,12,0,12,0,12,459,59,121,53,338,61,20769
1769,1769,15000US060855120531,778,107,52,38,35,32,17,20,726,110,98,57,628,105,20770
1770,1770,15000US060855120532,358,65,13,20,0,12,13,20,345,67,50,38,295,74,20771
1771,1771,15000US060855120533,297,57,21,21,21,21,0,12,276,55,48,36,228,54,20772
1772,1772,15000US060855121001,455,36,48,38,8,10,40,36,407,48,111,43,296,58,20773
1773,1773,15000US060855122001,607,97,0,12,0,12,0,12,607,97,133,65,474,96,20774
1774,1774,15000US060855122002,1050,104,0,12,0,12,0,12,1050,104,122,69,928,114,20775
1775,1775,15000US060855123051,1048,87,0,12,0,12,0,12,1048,87,212,100,836,123,20776
1776,1776,15000US060855123052,432,80,9,13,0,12,9,13,423,81,20,24,403,80,20777
1777,1777,15000US060855123071,430,76,43,48,19,29,24,40,387,76,47,44,340,78,20778
1778,1778,15000US060855123072,914,115,49,54,0,12,49,54,865,117,188,85,677,135,20779
1779,1779,15000US060855123073,1015,126,15,24,0,12,15,24,1000,125,348,91,652,127,20780
1780,1780,15000US060855123081,749,122,0,12,0,12,0,12,749,122,108,76,641,119,20781
1781,1781,15000US060855123082,791,144,0,12,0,12,0,12,791,144,80,64,711,135,20782
1782,1782,15000US060855123083,924,121,0,12,0,12,0,12,924,121,277,109,647,132,20783
1783,1783,15000US060855123091,996,80,106,75,0,12,106,75,890,103,246,75,644,100,20784
1784,1784,15000US060855123092,716,83,11,17,0,12,11,17,705,83,129,52,576,82,20785
1785,1785,15000US060855123101,1056,105,91,70,28,28,63,61,965,110,203,69,762,115,20786
1786,1786,15000US060855123102,391,85,56,52,0,12,56,52,335,82,47,50,288,77,20787
1787,1787,15000US060855123111,1189,59,0,12,0,12,0,12,1189,59,242,82,947,90,20788
1788,1788,15000US060855123121,1079,46,49,35,0,12,49,35,1030,57,210,62,820,76,20789
1789,1789,15000US060855123131,753,98,68,58,0,12,68,58,685,104,92,41,593,108,20790
1790,1790,15000US060855123132,433,98,66,53,42,43,24,40,367,85,97,48,270,89,20791
1791,1791,15000US060855123141,657,98,0,12,0,12,0,12,657,98,125,47,532,104,20792
1792,1792,15000US060855123142,256,77,27,23,18,16,9,14,229,74,42,46,187,62,20793
1793,1793,15000US060855123143,775,126,139,81,49,45,90,72,636,119,102,54,534,120,20794
1794,1794,15000US060855123144,470,92,43,40,0,12,43,40,427,87,35,39,392,82,20795
1795,1795,15000US060855124011,957,98,81,69,25,40,56,55,876,101,223,74,653,127,20796
1796,1796,15000US060855124012,463,88,11,19,0,12,11,19,452,86,137,51,315,90,20797
1797,1797,15000US060855124021,889,99,37,45,14,23,23,37,852,102,206,79,646,109,20798
1798,1798,15000US060855124022,238,67,24,33,0,12,24,33,214,68,35,29,179,66,20799
1799,1799,15000US060855124023,319,61,20,31,0,12,20,31,299,59,66,42,233,61,20800
1800,1800,15000US060855125031,1684,152,0,17,0,17,0,17,1684,152,222,117,1462,173,20801
1801,1801,15000US060855125032,1047,138,18,27,0,12,18,27,1029,139,114,67,915,142,20802
1802,1802,15000US060855125051,1262,138,26,29,16,25,10,16,1236,137,233,122,1003,144,20803
1803,1803,15000US060855125052,924,146,130,74,9,18,121,74,794,147,70,65,724,149,20804
1804,1804,15000US060855125061,733,100,195,83,61,54,134,68,538,105,69,47,469,105,20805
1805,1805,15000US060855125062,504,94,155,87,49,51,106,70,349,89,52,32,297,86,20806
1806,1806,15000US060855125063,669,85,124,50,30,39,94,56,545,84,133,48,412,90,20807
1807,1807,15000US060855125081,674,132,37,31,21,17,16,25,637,134,181,96,456,145,20808
1808,1808,15000US060855125082,887,161,205,120,25,36,180,122,682,160,222,141,460,141,20809
1809,1809,15000US060855125083,540,126,61,78,15,24,46,74,479,113,82,54,397,109,20810
1810,1810,15000US060855125084,529,144,76,67,44,57,32,36,453,155,127,86,326,151,20811
1811,1811,15000US060855125091,831,89,73,47,32,39,41,40,758,86,192,71,566,112,20812
1812,1812,15000US060855125092,396,76,0,12,0,12,0,12,396,76,64,36,332,75,20813
1813,1813,15000US060855125101,871,132,13,20,0,12,13,20,858,137,267,104,591,126,20814
1814,1814,15000US060855125102,346,89,33,36,19,28,14,23,313,86,36,37,277,85,20815
1815,1815,15000US060855125103,1041,182,55,68,41,63,14,21,986,179,123,77,863,181,20816
1816,1816,15000US060855126021,355,72,48,36,7,13,41,33,307,75,68,33,239,64,20817
1817,1817,15000US060855126022,447,55,40,34,19,24,21,24,407,56,108,39,299,53,20818
1818,1818,15000US060855126031,320,50,65,34,26,19,39,30,255,57,68,28,187,55,20819
1819,1819,15000US060855126032,215,43,45,31,17,18,28,25,170,43,29,23,141,41,20820
1820,1820,15000US060855126033,566,69,196,58,67,39,129,49,370,67,93,45,277,68,20821
1821,1821,15000US060855126041,475,69,112,53,0,12,112,53,363,78,125,48,238,79,20822
1822,1822,15000US060855126042,494,67,196,63,43,34,153,62,298,76,46,38,252,74,20823
1823,1823,15000US060855126043,205,48,63,54,26,39,37,37,142,43,44,33,98,37,20824
1824,1824,15000US060855130001,720,132,0,12,0,12,0,12,720,132,33,36,687,130,20825
1825,1825,15000US060855130002,634,104,0,12,0,12,0,12,634,104,14,22,620,103,20826
1826,1826,15000US060855130003,869,119,0,12,0,12,0,12,869,119,0,12,869,119,20827
1827,1827,15000US060855135001,306,51,0,12,0,12,0,12,306,51,42,28,264,53,20828
1828,1828,15000US060871001001,305,50,0,12,0,12,0,12,305,50,88,43,217,47,20829
1829,1829,15000US060871001002,496,45,7,10,0,12,7,10,489,43,103,35,386,52,20830
1830,1830,15000US060871002001,234,87,0,12,0,12,0,12,234,87,62,55,172,98,20831
1831,1831,15000US060871002002,269,97,0,12,0,12,0,12,269,97,23,26,246,100,20832
1832,1832,15000US060871002003,624,132,45,76,0,12,45,76,579,128,193,99,386,121,20833
1833,1833,15000US060871002004,230,87,0,12,0,12,0,12,230,87,18,29,212,96,20834
1834,1834,15000US060871002005,493,130,72,77,15,25,57,74,421,125,43,42,378,124,20835
1835,1835,15000US060871002006,487,103,82,56,30,28,52,49,405,105,108,69,297,101,20836
1836,1836,15000US060871002007,257,131,13,21,13,21,0,12,244,133,44,56,200,140,20837
1837,1837,15000US060871003001,614,89,85,68,0,12,85,68,529,96,124,50,405,101,20838
1838,1838,15000US060871003002,657,87,5,9,5,9,0,12,652,87,144,65,508,88,20839
1839,1839,15000US060871004001,157,39,5,5,0,12,5,5,152,38,13,11,139,40,20840
1840,1840,15000US060871004002,0,12,0,12,0,12,0,12,0,12,0,12,0,12,20841
1841,1841,15000US060871004003,278,66,90,40,31,18,59,37,188,56,15,15,173,53,20842
1842,1842,15000US060871005001,526,126,0,12,0,12,0,12,526,126,75,47,451,126,20843
1843,1843,15000US060871005002,801,130,27,24,12,21,15,25,774,133,77,52,697,138,20844
1844,1844,15000US060871005003,959,161,51,49,0,12,51,49,908,166,131,69,777,168,20845
1845,1845,15000US060871006001,565,93,42,33,10,15,32,29,523,95,76,41,447,102,20846
1846,1846,15000US060871006002,417,72,0,12,0,12,0,12,417,72,58,33,359,71,20847
1847,1847,15000US060871006003,302,66,18,19,9,13,9,14,284,67,52,37,232,72,20848
1848,1848,15000US060871007001,418,69,22,22,9,16,13,16,396,72,91,38,305,71,20849
1849,1849,15000US060871007002,547,75,78,47,29,43,49,35,469,78,177,74,292,84,20850
1850,1850,15000US060871008001,571,114,45,43,18,29,27,32,526,122,54,50,472,128,20851
1851,1851,15000US060871008002,339,121,0,12,0,12,0,12,339,121,69,48,270,123,20852
1852,1852,15000US060871008003,601,132,21,33,0,12,21,33,580,139,54,51,526,153,20853
1853,1853,15000US060871008004,807,218,115,110,0,12,115,110,692,223,56,54,636,222,20854
1854,1854,15000US060871008005,478,86,50,38,0,12,50,38,428,87,68,58,360,101,20855
1855,1855,15000US060871008006,210,73,41,47,0,12,41,47,169,66,12,20,157,67,20856
1856,1856,15000US060871009001,629,110,54,62,16,23,38,56,575,109,105,73,470,110,20857
1857,1857,15000US060871009002,722,151,45,71,0,12,45,71,677,165,236,121,441,152,20858
1858,1858,15000US060871009003,221,85,12,19,0,12,12,19,209,84,37,38,172,76,20859
1859,1859,15000US060871009004,144,69,0,12,0,12,0,12,144,69,32,49,112,66,20860
1860,1860,15000US060871009005,304,106,0,12,0,12,0,12,304,106,16,27,288,103,20861
1861,1861,15000US060871010001,857,190,183,125,94,101,89,89,674,176,105,77,569,182,20862
1862,1862,15000US060871010002,222,110,0,12,0,12,0,12,222,110,16,25,206,110,20863
1863,1863,15000US060871010003,229,102,0,12,0,12,0,12,229,102,0,12,229,102,20864
1864,1864,15000US060871010004,219,97,25,33,0,12,25,33,194,90,113,81,81,58,20865
1865,1865,15000US060871010005,226,98,7,18,0,12,7,18,219,97,39,46,180,95,20866
1866,1866,15000US060871010006,1195,204,170,101,70,59,100,90,1025,213,185,128,840,202,20867
1867,1867,15000US060871010007,770,188,74,52,0,12,74,52,696,191,55,49,641,191,20868
1868,1868,15000US060871011001,399,104,43,53,29,48,14,23,356,103,97,67,259,94,20869
1869,1869,15000US060871011002,451,101,0,12,0,12,0,12,451,101,75,57,376,96,20870
1870,1870,15000US060871011003,271,62,14,22,14,22,0,12,257,70,60,49,197,70,20871
1871,1871,15000US060871011004,576,126,33,39,0,12,33,39,543,130,94,54,449,130,20872
1872,1872,15000US060871011005,410,86,12,21,0,12,12,21,398,89,94,68,304,102,20873
1873,1873,15000US060871012001,302,65,27,25,12,18,15,17,275,66,40,33,235,67,20874
1874,1874,15000US060871012002,403,57,0,12,0,12,0,12,403,57,40,28,363,66,20875
1875,1875,15000US060871012003,545,80,8,12,0,12,8,12,537,83,91,40,446,90,20876
1876,1876,15000US060871101001,494,167,121,116,0,12,121,116,373,154,185,125,188,114,20877
1877,1877,15000US060871101002,346,141,163,121,73,84,90,89,183,107,30,36,153,99,20878
1878,1878,15000US060871101003,523,150,51,56,21,35,30,39,472,144,166,60,306,150,20879
1879,1879,15000US060871101004,1101,191,129,91,69,78,60,70,972,180,326,132,646,156,20880
1880,1880,15000US060871102001,473,117,68,67,54,63,14,23,405,113,128,78,277,104,20881
1881,1881,15000US060871102002,430,108,10,17,0,12,10,17,420,108,123,70,297,114,20882
1882,1882,15000US060871102003,303,109,34,34,23,29,11,17,269,121,34,42,235,117,20883
1883,1883,15000US060871102004,445,113,98,87,0,12,98,87,347,106,187,98,160,101,20884
1884,1884,15000US060871102005,542,123,27,42,0,12,27,42,515,111,139,66,376,120,20885
1885,1885,15000US060871103001,247,77,13,16,13,16,0,12,234,77,20,22,214,75,20886
1886,1886,15000US060871103002,362,90,137,61,31,35,106,53,225,85,105,54,120,67,20887
1887,1887,15000US060871103003,554,95,79,54,0,12,79,54,475,89,61,44,414,97,20888
1888,1888,15000US060871103004,609,95,275,84,86,58,189,81,334,104,66,45,268,98,20889
1889,1889,15000US060871104001,437,94,96,58,26,29,70,53,341,97,44,32,297,97,20890
1890,1890,15000US060871104002,282,90,63,44,0,12,63,44,219,84,73,41,146,86,20891
1891,1891,15000US060871104003,322,85,50,46,8,13,42,43,272,85,80,49,192,76,20892
1892,1892,15000US060871104004,895,109,80,60,15,24,65,54,815,101,125,61,690,113,20893
1893,1893,15000US060871105011,814,167,230,134,64,59,166,115,584,167,135,90,449,144,20894
1894,1894,15000US060871105012,577,158,95,76,34,51,61,48,482,145,111,62,371,142,20895
1895,1895,15000US060871105013,398,82,47,41,32,35,15,23,351,83,48,45,303,78,20896
1896,1896,15000US060871105014,310,121,17,29,17,29,0,12,293,129,53,52,240,127,20897
1897,1897,15000US060871105021,514,111,77,53,27,28,50,46,437,108,133,64,304,86,20898
1898,1898,15000US060871105022,530,107,127,69,13,17,114,71,403,103,84,44,319,103,20899
1899,1899,15000US060871105023,400,72,86,79,28,44,58,70,314,106,136,80,178,75,20900
1900,1900,15000US060871106001,635,172,141,110,40,47,101,100,494,162,150,106,344,156,20901
1901,1901,15000US060871106002,293,121,69,86,16,27,53,81,224,110,19,30,205,113,20902
1902,1902,15000US060871106003,347,106,59,51,17,26,42,46,288,105,93,61,195,91,20903
1903,1903,15000US060871106004,647,150,103,80,35,40,68,73,544,158,163,101,381,152,20904
1904,1904,15000US060871106005,258,88,51,51,27,31,24,39,207,78,22,33,185,74,20905
1905,1905,15000US060871107001,339,72,93,47,29,33,64,44,246,73,54,35,192,69,20906
1906,1906,15000US060871107002,333,71,33,32,25,32,8,11,300,72,80,40,220,65,20907
1907,1907,15000US060871107003,220,57,30,32,5,9,25,30,190,52,49,26,141,49,20908
1908,1908,15000US060871202001,1058,81,64,34,49,32,15,12,994,87,248,69,746,91,20909
1909,1909,15000US060871202002,553,69,5,7,0,12,5,7,548,69,157,43,391,64,20910
1910,1910,15000US060871203011,888,161,48,50,0,12,48,50,840,163,141,80,699,153,20911
1911,1911,15000US060871203012,569,102,0,12,0,12,0,12,569,102,89,62,480,110,20912
1912,1912,15000US060871203013,520,102,6,11,0,12,6,11,514,103,115,79,399,102,20913
1913,1913,15000US060871203021,243,65,14,16,7,12,7,13,229,63,55,38,174,56,20914
1914,1914,15000US060871203022,419,74,0,12,0,12,0,12,419,74,94,59,325,62,20915
1915,1915,15000US060871203023,388,92,39,43,0,12,39,43,349,101,80,53,269,90,20916
1916,1916,15000US060871204001,514,105,0,12,0,12,0,12,514,105,133,67,381,109,20917
1917,1917,15000US060871204002,389,90,32,36,0,12,32,36,357,91,22,26,335,90,20918
1918,1918,15000US060871204003,773,203,40,43,19,29,21,30,733,207,105,79,628,211,20919
1919,1919,15000US060871204004,425,88,80,73,68,70,12,20,345,74,26,29,319,76,20920
1920,1920,15000US060871205001,257,39,0,12,0,12,0,12,257,39,61,29,196,39,20921
1921,1921,15000US060871205002,649,98,0,12,0,12,0,12,649,98,154,63,495,95,20922
1922,1922,15000US060871205003,683,113,27,30,27,30,0,12,656,118,136,85,520,124,20923
1923,1923,15000US060871205004,599,139,13,20,13,20,0,12,586,140,97,52,489,144,20924
1924,1924,15000US060871205005,279,81,44,70,0,12,44,70,235,61,90,53,145,57,20925
1925,1925,15000US060871206001,247,73,0,12,0,12,0,12,247,73,87,51,160,69,20926
1926,1926,15000US060871206002,427,94,39,32,22,26,17,22,388,101,77,53,311,97,20927
1927,1927,15000US060871206003,245,68,14,22,0,12,14,22,231,66,59,38,172,63,20928
1928,1928,15000US060871206004,622,88,59,47,14,18,45,43,563,86,51,35,512,92,20929
1929,1929,15000US060871206005,324,54,8,14,0,12,8,14,316,53,41,31,275,57,20930
1930,1930,15000US060871207001,313,103,42,53,31,50,11,15,271,92,73,58,198,76,20931
1931,1931,15000US060871207002,587,100,32,33,32,33,0,12,555,95,73,44,482,84,20932
1932,1932,15000US060871207003,635,106,15,16,15,16,0,12,620,110,91,46,529,111,20933
1933,1933,15000US060871208001,927,140,0,12,0,12,0,12,927,140,332,113,595,134,20934
1934,1934,15000US060871208002,848,130,0,12,0,12,0,12,848,130,177,79,671,127,20935
1935,1935,15000US060871208003,555,112,0,12,0,12,0,12,555,112,90,46,465,112,20936
1936,1936,15000US060871209001,1037,176,42,43,0,12,42,43,995,183,189,88,806,182,20937
1937,1937,15000US060871209002,502,123,0,12,0,12,0,12,502,123,96,50,406,120,20938
1938,1938,15000US060871209003,893,131,43,44,29,41,14,21,850,127,169,83,681,125,20939
1939,1939,15000US060871209004,703,139,0,12,0,12,0,12,703,139,159,87,544,144,20940
1940,1940,15000US060871210001,623,69,0,12,0,12,0,12,623,69,94,49,529,77,20941
1941,1941,15000US060871210002,381,67,0,12,0,12,0,12,381,67,43,28,338,77,20942
1942,1942,15000US060871210003,372,61,6,7,0,12,6,7,366,62,24,21,342,63,20943
1943,1943,15000US060871211001,293,39,8,8,6,9,2,3,285,39,64,25,221,40,20944
1944,1944,15000US060871211002,901,58,34,28,23,21,11,14,867,59,179,56,688,77,20945
1945,1945,15000US060871212001,411,119,4,8,0,12,4,8,407,119,43,28,364,127,20946
1946,1946,15000US060871212002,503,85,0,12,0,12,0,12,503,85,84,42,419,92,20947
1947,1947,15000US060871212003,655,131,10,16,0,12,10,16,645,130,150,91,495,121,20948
1948,1948,15000US060871212004,354,70,0,12,0,12,0,12,354,70,126,76,228,57,20949
1949,1949,15000US060871212005,369,108,72,95,0,12,72,95,297,98,61,36,236,94,20950
1950,1950,15000US060871213001,905,84,36,25,8,13,28,22,869,88,191,58,678,94,20951
1951,1951,15000US060871213002,178,37,0,12,0,12,0,12,178,37,13,14,165,38,20952
1952,1952,15000US060871213003,405,74,34,39,34,39,0,12,371,70,36,33,335,72,20953
1953,1953,15000US060871213004,263,72,86,68,25,38,61,61,177,83,17,20,160,88,20954
1954,1954,15000US060871214011,364,59,61,34,34,20,27,27,303,67,77,37,226,59,20955
1955,1955,15000US060871214012,562,63,34,30,11,12,23,27,528,67,98,35,430,68,20956
1956,1956,15000US060871214021,617,84,48,39,25,29,23,25,569,87,171,66,398,81,20957
1957,1957,15000US060871214022,741,112,18,20,18,20,0,12,723,113,140,54,583,118,20958
1958,1958,15000US060871214023,241,64,7,12,0,12,7,12,234,65,55,37,179,64,20959
1959,1959,15000US060871214031,801,95,56,38,56,38,0,12,745,104,130,60,615,109,20960
1960,1960,15000US060871214032,371,54,0,12,0,12,0,12,371,54,81,58,290,62,20961
1961,1961,15000US060871214033,162,71,0,12,0,12,0,12,162,71,19,19,143,75,20962
1962,1962,15000US060871215001,258,93,0,12,0,12,0,12,258,93,21,32,237,101,20963
1963,1963,15000US060871215002,513,126,151,100,106,93,45,63,362,111,73,75,289,107,20964
1964,1964,15000US060871215003,714,138,21,33,0,12,21,33,693,138,168,84,525,147,20965
1965,1965,15000US060871215004,431,148,26,31,0,12,26,31,405,148,4,12,401,146,20966
1966,1966,15000US060871215005,455,124,104,100,79,90,25,41,351,121,32,31,319,124,20967
1967,1967,15000US060871216001,393,144,17,27,17,27,0,12,376,144,97,88,279,126,20968
1968,1968,15000US060871216002,395,124,34,53,0,12,34,53,361,115,78,61,283,94,20969
1969,1969,15000US060871216003,856,203,72,107,0,12,72,107,784,188,192,91,592,177,20970
1970,1970,15000US060871216004,715,146,0,12,0,12,0,12,715,146,50,49,665,149,20971
1971,1971,15000US060871216005,503,177,107,88,60,56,47,69,396,154,81,82,315,136,20972
1972,1972,15000US060871217001,1083,147,44,47,0,12,44,47,1039,145,175,96,864,149,20973
1973,1973,15000US060871217002,209,89,0,12,0,12,0,12,209,89,36,38,173,93,20974
1974,1974,15000US060871217003,264,75,16,26,16,26,0,12,248,73,11,18,237,77,20975
1975,1975,15000US060871217004,825,152,68,53,14,23,54,49,757,163,192,86,565,155,20976
1976,1976,15000US060871217005,325,100,0,12,0,12,0,12,325,100,45,45,280,106,20977
1977,1977,15000US060871217006,225,84,60,56,17,26,43,50,165,75,19,30,146,79,20978
1978,1978,15000US060871218001,450,112,23,29,0,12,23,29,427,112,108,59,319,116,20979
1979,1979,15000US060871218002,942,173,0,12,0,12,0,12,942,173,246,129,696,197,20980
1980,1980,15000US060871218003,550,116,30,35,18,28,12,20,520,119,131,71,389,128,20981
1981,1981,15000US060871218004,238,79,0,12,0,12,0,12,238,79,80,63,158,61,20982
1982,1982,15000US060871220011,578,92,36,29,20,23,16,18,542,98,62,36,480,101,20983
1983,1983,15000US060871220012,228,65,0,12,0,12,0,12,228,65,60,39,168,64,20984
1984,1984,15000US060871220013,320,76,104,85,43,68,61,60,216,52,37,22,179,47,20985
1985,1985,15000US060871220014,165,55,0,12,0,12,0,12,165,55,59,53,106,38,20986
1986,1986,15000US060871220015,562,64,0,12,0,12,0,12,562,64,86,34,476,63,20987
1987,1987,15000US060871220021,783,93,40,39,10,15,30,41,743,95,110,49,633,99,20988
1988,1988,15000US060871220022,496,83,10,16,0,12,10,16,486,81,135,66,351,83,20989
1989,1989,15000US060871220031,577,95,58,44,16,25,42,43,519,96,79,54,440,98,20990
1990,1990,15000US060871220032,371,101,0,12,0,12,0,12,371,101,64,49,307,110,20991
1991,1991,15000US060871220033,1113,126,57,41,27,32,30,34,1056,140,378,126,678,149,20992
1992,1992,15000US060871220034,349,124,15,22,0,12,15,22,334,125,48,38,286,123,20993
1993,1993,15000US060871220035,243,109,18,30,18,30,0,12,225,98,0,12,225,98,20994
1994,1994,15000US060871221001,380,82,13,15,0,12,13,15,367,84,84,60,283,72,20995
1995,1995,15000US060871221002,545,79,50,42,30,35,20,24,495,84,127,49,368,81,20996
1996,1996,15000US060871221003,526,85,27,24,27,24,0,12,499,87,134,60,365,88,20997
1997,1997,15000US060871222011,458,113,22,35,0,12,22,35,436,114,97,61,339,105,20998
1998,1998,15000US060871222012,501,163,0,12,0,12,0,12,501,163,144,101,357,156,20999
1999,1999,15000US060871222013,503,101,0,12,0,12,0,12,503,101,145,74,358,106,21000
2000,2000,15000US060871222014,328,102,0,12,0,12,0,12,328,102,0,12,328,102,21001
2001,2001,15000US060871222015,281,91,0,12,0,12,0,12,281,91,48,44,233,92,21002
2002,2002,15000US060871222016,524,114,0,12,0,12,0,12,524,114,31,35,493,115,21003
2003,2003,15000US060871222017,237,85,26,42,0,12,26,42,211,82,66,65,145,80,21004
2004,2004,15000US060871222021,929,55,31,29,21,24,10,15,898,61,181,51,717,74,21005
2005,2005,15000US060871222031,1043,94,39,45,0,12,39,45,1004,87,279,77,725,91,21006
2006,2006,15000US060871222032,590,77,38,21,16,18,22,19,552,78,108,54,444,83,21007
2007,2007,15000US060871223001,328,91,51,39,30,32,21,23,277,87,58,35,219,80,21008
2008,2008,15000US060871223002,282,60,6,9,6,9,0,12,276,60,59,37,217,55,21009
2009,2009,15000US060871223003,792,102,40,32,8,13,32,33,752,99,145,53,607,104,21010
2010,2010,15000US060871224001,770,130,76,61,20,34,56,53,694,130,148,83,546,140,21011
2011,2011,15000US060871224002,369,77,21,30,0,12,21,30,348,82,33,45,315,91,21012
2012,2012,15000US060871224003,553,135,35,40,0,12,35,40,518,130,147,92,371,115,21013
2013,2013,15000US060871224004,353,70,0,12,0,12,0,12,353,70,63,55,290,71,21014
2014,2014,15000US060871224005,189,67,0,12,0,12,0,12,189,67,58,58,131,73,21015
2015,2015,15000US060871224006,335,112,29,47,29,47,0,12,306,110,95,75,211,106,21016
2016,2016,15000US060871225001,394,90,28,27,19,21,9,15,366,96,77,44,289,102,21017
2017,2017,15000US060871225002,483,119,48,63,0,12,48,63,435,109,182,103,253,97,21018
2018,2018,15000US060871225003,319,91,39,46,26,40,13,20,280,84,100,51,180,76,21019
2019,2019,15000US060871225004,376,103,42,34,31,38,11,19,334,113,81,44,253,121,21020
2020,2020,15000US060871231001,485,57,43,39,27,35,16,14,442,57,155,50,287,63,21021
2021,2021,15000US060871231002,326,54,37,26,20,21,17,19,289,58,65,33,224,60,21022
2022,2022,15000US060871233001,474,33,28,30,10,11,18,27,446,42,51,29,395,48,21023
2023,2023,15000US060879901000,0,12,0,12,0,12,0,12,0,12,0,12,0,12,21024
2024,2024,15000US060890101001,354,80,24,22,6,9,18,24,330,77,133,50,197,71,21025
2025,2025,15000US060890101002,338,74,67,57,38,40,29,39,271,67,134,52,137,43,21026
2026,2026,15000US060890102001,1021,91,75,44,28,24,47,35,946,91,323,72,623,86,21027
2027,2027,15000US060890103001,653,100,75,40,27,34,48,33,578,100,204,69,374,105,21028
2028,2028,15000US060890103002,880,111,115,58,14,17,101,55,765,126,235,88,530,117,21029
2029,2029,15000US060890104001,462,92,18,20,18,20,0,12,444,93,182,77,262,71,21030
2030,2030,15000US060890104002,398,67,37,37,23,37,14,16,361,62,82,38,279,58,21031
2031,2031,15000US060890104003,252,60,25,20,16,18,9,17,227,63,97,50,130,60,21032
2032,2032,15000US060890104004,479,74,14,16,0,12,14,16,465,73,121,52,344,76,21033
2033,2033,15000US060890105001,704,171,125,90,76,62,49,57,579,178,239,136,340,149,21034
2034,2034,15000US060890105002,621,179,19,26,0,12,19,26,602,180,151,70,451,165,21035
2035,2035,15000US060890105003,753,168,73,76,15,23,58,70,680,180,172,75,508,188,21036
2036,2036,15000US060890106011,504,66,32,23,14,16,18,17,472,63,114,44,358,76,21037
2037,2037,15000US060890106012,467,54,0,12,0,12,0,12,467,54,114,33,353,56,21038
2038,2038,15000US060890106021,530,114,36,45,0,12,36,45,494,121,140,99,354,139,21039
2039,2039,15000US060890106022,317,110,0,12,0,12,0,12,317,110,30,35,287,112,21040
2040,2040,15000US060890106023,613,134,67,82,33,61,34,54,546,128,198,98,348,115,21041
2041,2041,15000US060890106024,798,155,15,26,15,26,0,12,783,154,276,163,507,166,21042
2042,2042,15000US060890106031,266,48,80,50,15,18,65,48,186,56,77,48,109,50,21043
2043,2043,15000US060890106032,349,45,0,12,0,12,0,12,349,45,79,37,270,46,21044
2044,2044,15000US060890107021,832,94,172,75,103,63,69,59,660,107,200,83,460,82,21045
2045,2045,15000US060890107022,775,88,24,38,24,38,0,12,751,92,185,74,566,87,21046
2046,2046,15000US060890107031,520,102,80,60,17,21,63,57,440,97,65,39,375,101,21047
2047,2047,15000US060890107032,1063,124,140,56,78,57,62,43,923,136,209,79,714,137,21048
2048,2048,15000US060890107041,560,120,64,39,54,37,10,13,496,120,200,74,296,102,21049
2049,2049,15000US060890107042,521,127,82,70,64,64,18,22,439,112,222,97,217,74,21050
2050,2050,15000US060890107043,833,120,138,73,68,56,70,51,695,117,264,97,431,115,21051
2051,2051,15000US060890108031,736,136,47,43,37,40,10,16,689,140,167,90,522,140,21052
2052,2052,15000US060890108032,492,136,87,64,61,62,26,30,405,137,49,66,356,126,21053
2053,2053,15000US060890108033,1014,151,162,112,33,44,129,104,852,147,246,84,606,154,21054
2054,2054,15000US060890108041,349,47,17,14,5,8,12,12,332,51,111,38,221,54,21055
2055,2055,15000US060890108042,554,46,0,12,0,12,0,12,554,46,211,51,343,53,21056
2056,2056,15000US060890108051,437,101,56,63,45,60,11,19,381,89,162,76,219,88,21057
2057,2057,15000US060890108052,1402,106,67,55,26,25,41,49,1335,116,379,91,956,144,21058
2058,2058,15000US060890108061,855,90,81,49,56,44,25,23,774,97,331,93,443,93,21059
2059,2059,15000US060890108062,567,87,73,47,34,28,39,37,494,98,189,73,305,96,21060
2060,2060,15000US060890108071,823,93,21,18,21,18,0,12,802,93,276,85,526,85,21061
2061,2061,15000US060890108072,804,92,26,25,7,13,19,21,778,96,224,74,554,95,21062
2062,2062,15000US060890109001,959,119,133,69,83,50,50,40,826,126,262,76,564,111,21063
2063,2063,15000US060890109002,726,108,39,26,26,25,13,15,687,111,168,69,519,119,21064
2064,2064,15000US060890110011,275,38,31,23,15,12,16,18,244,37,77,20,167,37,21065
2065,2065,15000US060890110012,340,45,4,7,4,7,0,12,336,45,79,35,257,44,21066
2066,2066,15000US060890110021,522,84,5,7,0,12,5,7,517,84,140,63,377,88,21067
2067,2067,15000US060890110022,429,99,75,78,43,70,32,35,354,77,104,71,250,78,21068
2068,2068,15000US060890110023,542,128,188,95,8,15,180,89,354,127,109,77,245,117,21069
2069,2069,15000US060890110024,629,142,109,80,74,76,35,42,520,138,152,74,368,138,21070
2070,2070,15000US060890111001,666,99,19,21,9,14,10,15,647,100,217,77,430,101,21071
2071,2071,15000US060890111002,493,88,0,12,0,12,0,12,493,88,103,57,390,87,21072
2072,2072,15000US060890112091,602,136,54,70,9,15,45,66,548,135,38,37,510,136,21073
2073,2073,15000US060890112092,525,126,179,110,74,73,105,72,346,117,131,83,215,103,21074
2074,2074,15000US060890112093,450,126,30,42,5,12,25,39,420,125,192,92,228,103,21075
2075,2075,15000US060890112094,470,146,249,137,175,125,74,75,221,110,67,70,154,92,21076
2076,2076,15000US060890113001,472,121,67,46,44,40,23,21,405,122,104,75,301,108,21077
2077,2077,15000US060890113002,422,115,66,39,24,26,42,30,356,113,161,85,195,67,21078
2078,2078,15000US060890113003,419,81,71,44,33,42,38,31,348,86,94,47,254,81,21079
2079,2079,15000US060890113004,495,95,77,55,47,50,30,32,418,88,94,75,324,99,21080
2080,2080,15000US060890114011,574,85,40,31,19,22,21,21,534,88,147,55,387,99,21081
2081,2081,15000US060890114012,463,77,36,31,20,23,16,21,427,83,90,41,337,81,21082
2082,2082,15000US060890114013,404,64,19,24,15,23,4,7,385,64,135,51,250,74,21083
2083,2083,15000US060890114021,494,67,7,11,0,12,7,11,487,67,106,49,381,69,21084
2084,2084,15000US060890114022,624,75,66,56,12,18,54,51,558,91,126,57,432,97,21085
2085,2085,15000US060890114031,520,87,0,12,0,12,0,12,520,87,159,61,361,81,21086
2086,2086,15000US060890114032,477,66,17,21,10,17,7,11,460,64,123,44,337,62,21087
2087,2087,15000US060890115001,288,123,0,12,0,12,0,12,288,123,157,114,131,77,21088
2088,2088,15000US060890115002,594,174,0,12,0,12,0,12,594,174,217,135,377,146,21089
2089,2089,15000US060890115003,870,196,89,66,73,62,16,24,781,186,231,105,550,178,21090
2090,2090,15000US060890115004,418,139,0,12,0,12,0,12,418,139,123,66,295,135,21091
2091,2091,15000US060890116001,337,70,0,12,0,12,0,12,337,70,127,56,210,70,21092
2092,2092,15000US060890116002,686,86,55,39,35,33,20,22,631,92,232,73,399,85,21093
2093,2093,15000US060890116003,458,92,115,58,21,22,94,54,343,86,108,46,235,80,21094
2094,2094,15000US060890117011,200,40,8,9,0,12,8,9,192,40,80,35,112,33,21095
2095,2095,15000US060890117012,635,73,78,47,14,20,64,42,557,77,148,53,409,74,21096
2096,2096,15000US060890117021,452,89,200,74,89,48,111,68,252,85,115,60,137,66,21097
2097,2097,15000US060890117022,460,84,54,34,26,24,28,27,406,89,115,49,291,88,21098
2098,2098,15000US060890117023,369,69,119,70,65,62,54,47,250,61,106,48,144,49,21099
2099,2099,15000US060890117031,353,72,12,14,12,14,0,12,341,76,102,54,239,78,21100
2100,2100,15000US060890117032,348,86,79,58,35,34,44,47,269,73,131,57,138,73,21101
2101,2101,15000US060890117033,496,82,35,30,8,13,27,31,461,89,145,55,316,103,21102
2102,2102,15000US060890118011,477,61,17,14,3,4,14,13,460,63,148,47,312,52,21103
2103,2103,15000US060890118012,419,49,25,15,5,7,20,13,394,50,139,45,255,52,21104
2104,2104,15000US060890118021,365,51,29,21,20,16,9,13,336,51,79,35,257,50,21105
2105,2105,15000US060890118022,573,69,43,26,22,18,21,22,530,67,144,48,386,64,21106
2106,2106,15000US060890118031,348,71,10,14,10,14,0,12,338,72,100,44,238,70,21107
2107,2107,15000US060890118032,323,77,21,23,9,14,12,19,302,77,116,41,186,71,21108
2108,2108,15000US060890118033,376,108,68,51,26,41,42,42,308,107,105,68,203,90,21109
2109,2109,15000US060890119001,499,89,16,18,7,11,9,14,483,89,126,66,357,88,21110
2110,2110,15000US060890119002,431,68,28,22,3,6,25,22,403,68,75,31,328,78,21111
2111,2111,15000US060890119003,375,66,3,5,3,5,0,12,372,67,129,53,243,54,21112
2112,2112,15000US060890119004,408,72,25,20,9,13,16,17,383,75,77,39,306,69,21113
2113,2113,15000US060890120001,279,78,23,20,8,11,15,17,256,78,54,41,202,83,21114
2114,2114,15000US060890120002,455,74,52,33,41,30,11,16,403,71,112,49,291,71,21115
2115,2115,15000US060890120003,394,104,203,76,91,58,112,58,191,91,46,40,145,88,21116
2116,2116,15000US060890120004,715,117,77,53,43,41,34,37,638,118,312,108,326,97,21117
2117,2117,15000US060890121011,438,91,51,36,19,21,32,33,387,87,171,69,216,93,21118
2118,2118,15000US060890121012,586,93,88,47,44,36,44,42,498,97,159,56,339,97,21119
2119,2119,15000US060890121013,728,104,60,40,52,39,8,13,668,112,233,80,435,102,21120
2120,2120,15000US060890121021,373,46,26,28,23,27,3,7,347,42,94,33,253,44,21121
2121,2121,15000US060890121022,511,84,83,40,40,28,43,29,428,83,214,55,214,68,21122
2122,2122,15000US060890122001,635,170,6,11,6,11,0,12,629,169,201,116,428,151,21123
2123,2123,15000US060890122002,350,109,0,12,0,12,0,12,350,109,77,53,273,113,21124
2124,2124,15000US060890122003,500,116,79,77,11,18,68,75,421,126,144,85,277,128,21125
2125,2125,15000US060890122004,661,153,97,82,17,29,80,84,564,147,223,120,341,147,21126
2126,2126,15000US060890123011,579,108,92,52,50,37,42,39,487,116,121,49,366,116,21127
2127,2127,15000US060890123012,540,87,159,61,62,34,97,54,381,95,207,81,174,79,21128
2128,2128,15000US060890123021,422,97,17,29,0,12,17,29,405,97,139,91,266,104,21129
2129,2129,15000US060890123022,151,67,28,43,28,43,0,12,123,68,68,62,55,46,21130
2130,2130,15000US060890123023,635,117,22,33,22,33,0,12,613,125,218,78,395,127,21131
2131,2131,15000US060890123024,848,145,13,22,13,22,0,12,835,147,220,107,615,158,21132
2132,2132,15000US060890123031,726,80,11,17,11,17,0,12,715,80,253,86,462,90,21133
2133,2133,15000US060890123032,758,88,78,50,56,44,22,26,680,91,208,74,472,97,21134
2134,2134,15000US060890124001,476,67,49,31,35,27,14,14,427,66,162,47,265,64,21135
2135,2135,15000US060890124002,364,61,40,27,19,12,21,25,324,63,101,49,223,65,21136
2136,2136,15000US060890124003,730,97,45,36,3,5,42,36,685,91,147,46,538,91,21137
2137,2137,15000US060890125001,269,55,10,10,10,10,0,12,259,55,113,35,146,43,21138
2138,2138,15000US060890125002,397,75,55,36,41,34,14,12,342,70,110,43,232,69,21139
2139,2139,15000US060890126011,680,100,70,48,15,21,55,42,610,106,207,99,403,87,21140
2140,2140,15000US060890126012,508,69,18,15,8,10,10,11,490,70,190,48,300,57,21141
2141,2141,15000US060890126013,748,103,25,15,7,6,18,14,723,103,274,67,449,90,21142
2142,2142,15000US060890126031,357,96,9,15,0,12,9,15,348,97,104,40,244,91,21143
2143,2143,15000US060890126032,556,100,10,17,10,17,0,12,546,99,302,80,244,92,21144
2144,2144,15000US060890126033,416,101,32,28,32,28,0,12,384,102,257,95,127,62,21145
2145,2145,15000US060890126034,377,63,26,23,7,11,19,20,351,63,158,60,193,54,21146
2146,2146,15000US060890126041,351,51,5,9,5,9,0,12,346,51,125,49,221,44,21147
2147,2147,15000US060890126042,560,64,30,21,19,19,11,8,530,67,160,43,370,57,21148
2148,2148,15000US060890127011,739,127,75,64,50,50,25,26,664,130,177,85,487,109,21149
2149,2149,15000US060890127012,330,102,46,50,22,34,24,38,284,97,173,92,111,47,21150
2150,2150,15000US060890127013,529,101,77,48,42,33,35,45,452,97,121,55,331,93,21151
2151,2151,15000US060890127014,274,78,8,12,8,12,0,12,266,79,82,55,184,73,21152
2152,2152,15000US060890127021,247,74,22,25,22,25,0,12,225,70,123,67,102,54,21153
2153,2153,15000US060890127022,527,113,65,40,65,40,0,12,462,119,100,56,362,117,21154
2154,2154,15000US060890127023,548,115,25,40,0,12,25,40,523,117,273,105,250,98,21155
2155,2155,15000US060910100001,250,80,10,13,2,3,8,12,240,78,53,30,187,77,21156
2156,2156,15000US060910100002,284,82,38,25,15,14,23,21,246,76,105,66,141,53,21157
2157,2157,15000US060910100003,192,91,5,11,5,11,0,12,187,89,71,57,116,69,21158
2158,2158,15000US060910100004,375,96,0,12,0,12,0,12,375,96,13,22,362,96,21159
2159,2159,15000US060910100005,174,65,0,12,0,12,0,12,174,65,54,39,120,61,21160
2160,2160,15000US060930001001,486,51,65,28,14,12,51,25,421,55,161,42,260,43,21161
2161,2161,15000US060930002001,709,65,64,32,11,8,53,29,645,63,218,53,427,56,21162
2162,2162,15000US060930003001,669,69,96,33,44,25,52,26,573,66,207,50,366,52,21163
2163,2163,15000US060930003002,513,62,72,42,64,41,8,8,441,58,188,47,253,55,21164
2164,2164,15000US060930003003,507,62,55,21,21,11,34,19,452,62,195,40,257,54,21165
2165,2165,15000US060930004001,270,36,43,21,20,13,23,16,227,37,83,25,144,33,21166
2166,2166,15000US060930005001,409,53,52,26,39,22,13,11,357,53,141,37,216,39,21167
2167,2167,15000US060930005002,277,46,30,26,5,8,25,25,247,48,100,31,147,44,21168
2168,2168,15000US060930005003,199,41,14,9,9,8,5,8,185,40,39,19,146,35,21169
2169,2169,15000US060930006001,746,69,49,22,24,18,25,20,697,70,229,60,468,64,21170
2170,2170,15000US060930007011,293,43,28,19,11,12,17,15,265,41,95,34,170,42,21171
2171,2171,15000US060930007012,527,98,57,38,23,20,34,31,470,97,189,67,281,95,21172
2172,2172,15000US060930007013,485,82,61,32,38,23,23,22,424,80,102,36,322,82,21173
2173,2173,15000US060930007014,317,63,29,22,18,13,11,17,288,65,122,45,166,55,21174
2174,2174,15000US060930007021,909,113,231,85,138,78,93,52,678,132,302,80,376,124,21175
2175,2175,15000US060930007022,1100,135,286,96,139,79,147,68,814,124,395,84,419,99,21176
2176,2176,15000US060930007031,290,64,55,52,34,44,21,33,235,49,113,55,122,54,21177
2177,2177,15000US060930007032,538,99,127,66,67,63,60,42,411,88,168,66,243,71,21178
2178,2178,15000US060930007033,567,87,88,44,46,38,42,48,479,98,108,45,371,92,21179
2179,2179,15000US060930008001,842,115,130,72,71,55,59,43,712,106,190,73,522,106,21180
2180,2180,15000US060930008002,214,53,36,21,28,22,8,10,178,45,83,33,95,37,21181
2181,2181,15000US060930008003,377,76,60,38,41,35,19,15,317,69,50,21,267,68,21182
2182,2182,15000US060930009001,253,67,79,50,45,26,34,44,174,50,96,42,78,34,21183
2183,2183,15000US060930009002,556,122,94,48,44,36,50,39,462,132,150,114,312,98,21184
2184,2184,15000US060930009003,265,57,100,41,8,8,92,42,165,53,97,45,68,33,21185
2185,2185,15000US060930009004,1351,109,97,44,65,39,32,23,1254,107,336,58,918,100,21186
2186,2186,15000US060930009005,327,63,52,33,35,28,17,20,275,63,117,45,158,53,21187
2187,2187,15000US060930009006,212,54,15,19,1,3,14,19,197,53,45,27,152,51,21188
2188,2188,15000US060930010001,218,89,37,40,0,12,37,40,181,101,85,58,96,88,21189
2189,2189,15000US060930010002,494,94,39,44,0,12,39,44,455,95,117,63,338,105,21190
2190,2190,15000US060930010003,989,161,34,40,20,32,14,22,955,169,237,128,718,168,21191
2191,2191,15000US060930010004,871,138,81,58,13,22,68,53,790,134,174,76,616,127,21192
2192,2192,15000US060930010005,720,138,0,12,0,12,0,12,720,138,224,103,496,163,21193
2193,2193,15000US060930011001,191,44,28,20,10,13,18,15,163,44,25,16,138,45,21194
2194,2194,15000US060930011002,318,49,31,19,17,13,14,14,287,47,74,29,213,47,21195
2195,2195,15000US060930011003,423,56,68,30,31,16,37,25,355,48,144,32,211,44,21196
2196,2196,15000US060930012001,613,68,42,27,7,8,35,27,571,69,191,47,380,66,21197
2197,2197,15000US060952501031,455,97,67,57,25,34,42,46,388,78,113,58,275,71,21198
2198,2198,15000US060952501032,705,115,111,66,37,28,74,60,594,120,116,53,478,124,21199
2199,2199,15000US060952501033,387,100,15,17,0,12,15,17,372,101,106,56,266,83,21200
2200,2200,15000US060952501041,336,58,19,15,10,10,9,11,317,63,45,27,272,64,21201
2201,2201,15000US060952501042,478,64,58,37,47,35,11,11,420,72,153,49,267,63,21202
2202,2202,15000US060952501051,709,164,39,48,19,32,20,34,670,171,149,97,521,179,21203
2203,2203,15000US060952501052,725,187,18,22,7,14,11,17,707,192,268,140,439,180,21204
2204,2204,15000US060952501053,773,208,29,47,29,47,0,12,744,200,224,171,520,138,21205
2205,2205,15000US060952501061,608,84,0,12,0,12,0,12,608,84,132,48,476,76,21206
2206,2206,15000US060952501062,788,90,7,12,7,12,0,12,781,90,147,64,634,100,21207
2207,2207,15000US060952502001,609,111,94,51,16,20,78,48,515,117,130,55,385,115,21208
2208,2208,15000US060952502002,302,88,8,14,0,12,8,14,294,87,61,40,233,91,21209
2209,2209,15000US060952502003,561,117,41,32,37,29,4,9,520,119,220,102,300,110,21210
2210,2210,15000US060952503001,445,81,70,60,41,46,29,37,375,79,142,63,233,67,21211
2211,2211,15000US060952503002,402,107,120,67,35,34,85,64,282,103,122,77,160,67,21212
2212,2212,15000US060952503003,267,92,3,14,3,14,0,12,264,88,67,42,197,87,21213
2213,2213,15000US060952504001,313,70,38,30,17,20,21,21,275,76,90,39,185,73,21214
2214,2214,15000US060952504002,435,82,10,16,0,12,10,16,425,82,104,45,321,81,21215
2215,2215,15000US060952504003,286,67,53,41,42,38,11,16,233,60,90,44,143,66,21216
2216,2216,15000US060952505011,381,55,44,37,8,13,36,34,337,61,78,35,259,60,21217
2217,2217,15000US060952505012,395,58,23,24,18,22,5,8,372,54,83,39,289,61,21218
2218,2218,15000US060952505021,472,96,27,23,8,12,19,21,445,97,132,77,313,76,21219
2219,2219,15000US060952505022,528,94,33,31,33,31,0,12,495,94,144,60,351,74,21220
2220,2220,15000US060952506011,626,95,93,67,80,65,13,20,533,116,136,57,397,92,21221
2221,2221,15000US060952506012,705,105,84,54,10,15,74,51,621,103,297,112,324,84,21222
2222,2222,15000US060952506013,229,74,47,50,38,48,9,14,182,61,41,30,141,65,21223
2223,2223,15000US060952506041,621,108,22,25,12,21,10,14,599,111,97,57,502,111,21224
2224,2224,15000US060952506042,369,64,0,12,0,12,0,12,369,64,58,34,311,69,21225
2225,2225,15000US060952506043,394,83,29,47,0,12,29,47,365,67,61,39,304,65,21226
2226,2226,15000US060952506051,355,85,7,13,0,12,7,13,348,84,60,42,288,89,21227
2227,2227,15000US060952506052,441,76,12,18,0,12,12,18,429,76,61,44,368,75,21228
2228,2228,15000US060952506053,781,99,53,46,8,14,45,44,728,105,90,48,638,112,21229
2229,2229,15000US060952507011,615,113,136,70,41,33,95,62,479,124,157,78,322,117,21230
2230,2230,15000US060952507012,517,99,53,49,26,30,27,42,464,105,146,71,318,115,21231
2231,2231,15000US060952508011,580,58,10,14,10,14,0,12,570,60,173,64,397,74,21232
2232,2232,15000US060952508012,404,73,75,52,49,36,26,42,329,76,143,53,186,68,21233
2233,2233,15000US060952508013,452,102,86,61,14,21,72,59,366,100,68,52,298,94,21234
2234,2234,15000US060952509001,407,126,201,105,47,58,154,101,206,83,117,65,89,55,21235
2235,2235,15000US060952509002,800,129,301,84,80,55,221,78,499,102,128,62,371,101,21236
2236,2236,15000US060952510001,424,89,154,65,43,56,111,52,270,83,42,32,228,80,21237
2237,2237,15000US060952510002,310,82,51,49,7,11,44,47,259,76,75,49,184,70,21238
2238,2238,15000US060952510003,324,99,25,24,7,11,18,21,299,103,28,23,271,105,21239
2239,2239,15000US060952511001,727,103,72,56,7,11,65,55,655,103,161,68,494,93,21240
2240,2240,15000US060952511002,378,99,90,55,54,41,36,36,288,96,74,67,214,97,21241
2241,2241,15000US060952512001,490,86,62,49,36,47,26,22,428,91,96,59,332,89,21242
2242,2242,15000US060952512002,440,89,78,61,46,51,32,33,362,97,56,38,306,99,21243
2243,2243,15000US060952512003,352,83,38,31,18,21,20,23,314,82,55,42,259,89,21244
2244,2244,15000US060952513001,368,74,0,12,0,12,0,12,368,74,59,30,309,76,21245
2245,2245,15000US060952513002,353,57,27,28,27,28,0,12,326,58,117,48,209,58,21246
2246,2246,15000US060952513003,458,82,20,21,20,21,0,12,438,85,132,46,306,88,21247
2247,2247,15000US060952514001,784,178,112,100,29,33,83,94,672,166,138,90,534,165,21248
2248,2248,15000US060952514002,562,131,33,37,0,12,33,37,529,131,144,65,385,141,21249
2249,2249,15000US060952514003,780,167,169,124,32,39,137,124,611,135,132,62,479,139,21250
2250,2250,15000US060952515001,310,95,65,52,9,15,56,60,245,81,66,49,179,81,21251
2251,2251,15000US060952515002,464,120,151,114,49,67,102,98,313,92,81,59,232,84,21252
2252,2252,15000US060952515003,690,100,277,92,104,76,173,76,413,86,100,50,313,88,21253
2253,2253,15000US060952516001,299,85,51,42,0,12,51,42,248,83,23,22,225,79,21254
2254,2254,15000US060952516002,770,101,111,66,56,54,55,40,659,103,133,67,526,106,21255
2255,2255,15000US060952517011,599,83,175,89,43,49,132,78,424,87,166,59,258,77,21256
2256,2256,15000US060952517012,769,101,123,63,45,37,78,53,646,102,166,58,480,92,21257
2257,2257,15000US060952517021,370,61,23,16,18,14,5,7,347,62,89,39,258,62,21258
2258,2258,15000US060952517022,567,86,74,45,23,25,51,39,493,93,67,28,426,92,21259
2259,2259,15000US060952518021,1213,107,359,110,121,64,238,96,854,121,384,99,470,114,21260
2260,2260,15000US060952518031,257,68,33,50,0,12,33,50,224,61,35,29,189,52,21261
2261,2261,15000US060952518032,292,84,18,26,6,12,12,25,274,85,45,35,229,77,21262
2262,2262,15000US060952518033,366,87,24,34,24,34,0,12,342,85,84,56,258,89,21263
2263,2263,15000US060952518034,469,109,6,22,6,22,0,12,463,108,64,50,399,103,21264
2264,2264,15000US060952518041,322,66,74,55,16,27,58,51,248,59,92,31,156,59,21265
2265,2265,15000US060952518042,329,57,18,19,6,11,12,15,311,60,75,31,236,61,21266
2266,2266,15000US060952518043,321,67,12,14,5,7,7,12,309,68,72,38,237,63,21267
2267,2267,15000US060952519011,769,120,145,88,34,28,111,87,624,115,171,65,453,108,21268
2268,2268,15000US060952519012,365,82,31,46,31,46,0,12,334,72,175,54,159,60,21269
2269,2269,15000US060952519013,695,115,100,51,74,43,26,29,595,114,198,80,397,117,21270
2270,2270,15000US060952519021,365,83,0,12,0,12,0,12,365,83,181,67,184,83,21271
2271,2271,15000US060952519022,560,122,81,65,72,64,9,13,479,102,153,70,326,93,21272
2272,2272,15000US060952519023,286,92,61,72,0,12,61,72,225,81,28,26,197,80,21273
2273,2273,15000US060952519024,562,112,161,99,38,56,123,79,401,100,123,47,278,100,21274
2274,2274,15000US060952519031,377,78,30,29,8,14,22,24,347,74,81,49,266,73,21275
2275,2275,15000US060952519032,643,100,49,39,6,10,43,39,594,104,143,65,451,112,21276
2276,2276,15000US060952519033,633,94,68,37,43,31,25,38,565,91,75,37,490,98,21277
2277,2277,15000US060952520001,744,137,45,70,0,12,45,70,699,127,230,83,469,141,21278
2278,2278,15000US060952520002,410,109,13,21,13,21,0,12,397,106,45,36,352,106,21279
2279,2279,15000US060952520003,512,132,26,42,0,12,26,42,486,135,187,123,299,134,21280
2280,2280,15000US060952520004,482,117,0,12,0,12,0,12,482,117,49,52,433,117,21281
2281,2281,15000US060952521021,777,115,76,71,16,20,60,66,701,115,217,79,484,116,21282
2282,2282,15000US060952521022,696,107,83,64,45,50,38,42,613,105,108,78,505,98,21283
2283,2283,15000US060952521031,477,100,23,37,23,37,0,12,454,104,25,21,429,104,21284
2284,2284,15000US060952521032,730,97,0,12,0,12,0,12,730,97,211,74,519,118,21285
2285,2285,15000US060952521033,773,131,34,28,9,14,25,24,739,132,140,82,599,145,21286
2286,2286,15000US060952521041,825,80,91,39,0,12,91,39,734,80,145,53,589,83,21287
2287,2287,15000US060952521042,521,75,0,12,0,12,0,12,521,75,80,41,441,80,21288
2288,2288,15000US060952521043,466,71,0,12,0,12,0,12,466,71,84,46,382,76,21289
2289,2289,15000US060952521051,645,71,0,12,0,12,0,12,645,71,172,61,473,71,21290
2290,2290,15000US060952521052,605,88,39,47,0,12,39,47,566,88,95,56,471,79,21291
2291,2291,15000US060952521061,614,79,0,12,0,12,0,12,614,79,185,67,429,95,21292
2292,2292,15000US060952521062,448,73,0,12,0,12,0,12,448,73,66,38,382,77,21293
2293,2293,15000US060952521063,655,99,42,37,8,12,34,41,613,105,123,60,490,108,21294
2294,2294,15000US060952521071,914,76,8,13,0,12,8,13,906,73,181,71,725,95,21295
2295,2295,15000US060952521072,490,62,0,12,0,12,0,12,490,62,127,49,363,70,21296
2296,2296,15000US060952521081,542,66,11,17,0,12,11,17,531,71,75,40,456,77,21297
2297,2297,15000US060952521082,803,76,23,25,0,12,23,25,780,79,133,55,647,89,21298
2298,2298,15000US060952522011,1344,158,58,59,0,12,58,59,1286,175,184,104,1102,187,21299
2299,2299,15000US060952522012,257,72,0,12,0,12,0,12,257,72,45,41,212,77,21300
2300,2300,15000US060952522013,254,58,0,12,0,12,0,12,254,58,79,46,175,64,21301
2301,2301,15000US060952522014,1175,132,48,45,34,39,14,23,1127,138,151,81,976,154,21302
2302,2302,15000US060952522021,490,118,47,74,47,74,0,12,443,108,21,24,422,111,21303
2303,2303,15000US060952522022,721,143,13,20,13,20,0,12,708,147,119,103,589,155,21304
2304,2304,15000US060952522023,618,106,0,12,0,12,0,12,618,106,133,69,485,115,21305
2305,2305,15000US060952522024,1362,168,23,36,0,12,23,36,1339,171,207,93,1132,185,21306
2306,2306,15000US060952523051,782,107,15,22,0,12,15,22,767,104,109,57,658,102,21307
2307,2307,15000US060952523052,238,62,0,12,0,12,0,12,238,62,67,34,171,58,21308
2308,2308,15000US060952523053,660,94,31,44,0,12,31,44,629,102,186,69,443,92,21309
2309,2309,15000US060952523061,444,63,11,15,11,15,0,12,433,65,148,56,285,68,21310
2310,2310,15000US060952523062,797,77,11,17,0,12,11,17,786,81,152,66,634,92,21311
2311,2311,15000US060952523101,947,78,0,12,0,12,0,12,947,78,344,92,603,107,21312
2312,2312,15000US060952523102,314,72,14,22,0,12,14,22,300,71,93,43,207,62,21313
2313,2313,15000US060952523111,430,63,0,12,0,12,0,12,430,63,163,60,267,50,21314
2314,2314,15000US060952523112,734,87,20,23,0,12,20,23,714,90,136,61,578,90,21315
2315,2315,15000US060952523113,285,51,0,12,0,12,0,12,285,51,70,43,215,52,21316
2316,2316,15000US060952523121,551,66,8,13,8,13,0,12,543,64,122,41,421,68,21317
2317,2317,15000US060952523122,791,97,121,62,42,47,79,45,670,101,128,63,542,106,21318
2318,2318,15000US060952523131,517,137,142,127,0,12,142,127,375,120,33,26,342,128,21319
2319,2319,15000US060952523132,647,153,28,51,28,51,0,12,619,170,293,114,326,134,21320
2320,2320,15000US060952523133,1029,146,0,12,0,12,0,12,1029,146,343,121,686,146,21321
2321,2321,15000US060952523141,392,88,53,54,37,52,16,22,339,88,100,52,239,87,21322
2322,2322,15000US060952523142,352,86,0,12,0,12,0,12,352,86,117,59,235,84,21323
2323,2323,15000US060952523143,617,105,77,45,44,35,33,29,540,96,100,52,440,100,21324
2324,2324,15000US060952523151,442,68,30,39,23,37,7,12,412,74,146,59,266,70,21325
2325,2325,15000US060952523152,438,85,16,21,0,12,16,21,422,83,96,60,326,81,21326
2326,2326,15000US060952523153,556,68,11,14,11,14,0,12,545,72,142,71,403,79,21327
2327,2327,15000US060952523161,594,86,0,12,0,12,0,12,594,86,138,59,456,86,21328
2328,2328,15000US060952523162,544,67,96,68,41,44,55,51,448,70,160,66,288,78,21329
2329,2329,15000US060952523171,685,134,0,12,0,12,0,12,685,134,141,100,544,137,21330
2330,2330,15000US060952523172,1468,148,0,17,0,17,0,17,1468,148,281,104,1187,155,21331
2331,2331,15000US060952524011,298,73,15,17,10,15,5,9,283,74,90,50,193,69,21332
2332,2332,15000US060952524012,286,75,7,11,7,11,0,12,279,76,100,54,179,64,21333
2333,2333,15000US060952524013,313,55,52,41,52,41,0,12,261,58,92,41,169,51,21334
2334,2334,15000US060952524014,416,79,64,48,0,12,64,48,352,84,56,43,296,84,21335
2335,2335,15000US060952524021,413,110,23,33,0,12,23,33,390,114,115,60,275,114,21336
2336,2336,15000US060952524022,622,104,34,34,8,14,26,33,588,102,224,59,364,102,21337
2337,2337,15000US060952524023,714,110,250,98,50,35,200,102,464,112,90,47,374,105,21338
2338,2338,15000US060952525011,173,44,45,31,35,30,10,11,128,43,9,11,119,42,21339
2339,2339,15000US060952525012,740,61,151,60,70,48,81,45,589,73,272,77,317,71,21340
2340,2340,15000US060952525021,319,46,78,40,42,32,36,29,241,52,77,40,164,44,21341
2341,2341,15000US060952525022,335,53,56,44,6,8,50,43,279,61,37,21,242,64,21342
2342,2342,15000US060952526041,160,56,39,38,18,29,21,25,121,43,31,24,90,44,21343
2343,2343,15000US060952526042,535,101,151,89,32,38,119,85,384,100,60,36,324,98,21344
2344,2344,15000US060952526043,343,107,78,57,28,37,50,49,265,97,66,50,199,92,21345
2345,2345,15000US060952526051,1105,126,320,112,146,80,174,93,785,147,221,102,564,136,21346
2346,2346,15000US060952526052,470,88,65,49,20,33,45,34,405,96,102,34,303,97,21347
2347,2347,15000US060952526053,320,84,118,67,60,56,58,39,202,75,105,67,97,48,21348
2348,2348,15000US060952526061,752,107,122,80,63,45,59,63,630,104,306,82,324,100,21349
2349,2349,15000US060952526062,393,102,80,60,23,33,57,53,313,97,66,47,247,95,21350
2350,2350,15000US060952526063,487,96,107,81,51,53,56,54,380,98,65,48,315,89,21351
2351,2351,15000US060952526071,320,79,46,35,9,10,37,34,274,78,80,34,194,76,21352
2352,2352,15000US060952526072,830,92,148,79,61,60,87,59,682,94,90,60,592,97,21353
2353,2353,15000US060952526081,343,84,69,63,9,13,60,62,274,70,75,49,199,58,21354
2354,2354,15000US060952526082,945,93,248,92,151,84,97,60,697,101,287,101,410,98,21355
2355,2355,15000US060952526101,573,81,139,85,102,87,37,37,434,85,138,54,296,82,21356
2356,2356,15000US060952526102,455,67,35,31,15,18,20,29,420,74,109,55,311,78,21357
2357,2357,15000US060952526111,411,86,99,62,28,24,71,56,312,80,160,74,152,75,21358
2358,2358,15000US060952526112,282,83,5,8,5,8,0,12,277,84,80,64,197,66,21359
2359,2359,15000US060952526113,381,87,157,86,0,12,157,86,224,87,74,61,150,90,21360
2360,2360,15000US060952527021,581,149,51,61,36,56,15,23,530,144,114,84,416,130,21361
2361,2361,15000US060952527022,283,118,68,81,15,24,53,75,215,104,60,60,155,90,21362
2362,2362,15000US060952527023,236,89,100,87,0,12,100,87,136,62,0,12,136,62,21363
2363,2363,15000US060952527024,442,126,20,24,9,16,11,18,422,127,70,59,352,118,21364
2364,2364,15000US060952527025,343,90,0,12,0,12,0,12,343,90,16,18,327,89,21365
2365,2365,15000US060952527026,354,99,39,59,39,59,0,12,315,97,76,59,239,94,21366
2366,2366,15000US060952527031,279,69,28,30,14,21,14,21,251,63,9,15,242,61,21367
2367,2367,15000US060952527032,497,99,8,15,8,15,0,12,489,99,92,48,397,96,21368
2368,2368,15000US060952527033,442,96,31,39,0,12,31,39,411,99,125,80,286,96,21369
2369,2369,15000US060952527041,415,95,76,60,32,35,44,62,339,85,123,65,216,72,21370
2370,2370,15000US060952527042,225,82,20,22,11,17,9,14,205,85,43,28,162,86,21371
2371,2371,15000US060952527043,271,70,16,24,0,12,16,24,255,72,76,51,179,76,21372
2372,2372,15000US060952527044,154,53,0,12,0,12,0,12,154,53,24,22,130,53,21373
2373,2373,15000US060952527045,590,93,57,58,6,9,51,57,533,99,245,79,288,89,21374
2374,2374,15000US060952527051,402,109,12,17,0,12,12,17,390,108,36,27,354,107,21375
2375,2375,15000US060952527052,249,77,8,13,0,12,8,13,241,78,159,72,82,47,21376
2376,2376,15000US060952527053,220,54,0,12,0,12,0,12,220,54,49,31,171,62,21377
2377,2377,15000US060952527054,547,103,51,44,0,12,51,44,496,105,142,71,354,105,21378
2378,2378,15000US060952527055,369,78,19,23,5,8,14,22,350,77,64,33,286,80,21379
2379,2379,15000US060952527061,1193,50,18,19,7,11,11,15,1175,53,313,82,862,95,21380
2380,2380,15000US060952527071,798,87,219,86,122,69,97,62,579,88,216,79,363,111,21381
2381,2381,15000US060952527072,676,102,93,70,47,35,46,60,583,97,223,67,360,87,21382
2382,2382,15000US060952527073,203,63,5,12,5,12,0,12,198,64,68,35,130,61,21383
2383,2383,15000US060952528011,18,21,0,12,0,12,0,12,18,21,0,12,18,21,21384
2384,2384,15000US060952528012,0,12,0,12,0,12,0,12,0,12,0,12,0,12,21385
2385,2385,15000US060952528013,303,51,0,12,0,12,0,12,303,51,29,29,274,56,21386
2386,2386,15000US060952528014,357,59,0,12,0,12,0,12,357,59,49,32,308,60,21387
2387,2387,15000US060952528015,162,58,0,12,0,12,0,12,162,58,38,39,124,41,21388
2388,2388,15000US060952528021,280,71,0,12,0,12,0,12,280,71,13,15,267,71,21389
2389,2389,15000US060952528022,0,12,0,12,0,12,0,12,0,12,0,12,0,12,21390
2390,2390,15000US060952529031,408,79,46,38,10,16,36,35,362,72,85,49,277,83,21391
2391,2391,15000US060952529032,359,65,9,15,9,15,0,12,350,66,78,40,272,59,21392
2392,2392,15000US060952529033,555,80,0,12,0,12,0,12,555,80,130,48,425,79,21393
2393,2393,15000US060952529034,343,77,44,50,16,18,28,46,299,71,78,38,221,75,21394
2394,2394,15000US060952529041,640,100,8,13,8,13,0,12,632,100,217,80,415,113,21395
2395,2395,15000US060952529042,1182,134,44,36,27,29,17,22,1138,136,122,63,1016,149,21396
2396,2396,15000US060952529043,432,97,11,18,11,18,0,12,421,99,90,61,331,92,21397
2397,2397,15000US060952529081,333,79,13,14,13,14,0,12,320,80,53,34,267,85,21398
2398,2398,15000US060952529082,671,90,114,83,58,42,56,64,557,93,74,44,483,94,21399
2399,2399,15000US060952529083,279,77,0,12,0,12,0,12,279,77,105,59,174,66,21400
2400,2400,15000US060952529091,516,77,32,28,21,23,11,18,484,77,106,46,378,82,21401
2401,2401,15000US060952529092,534,71,8,14,0,12,8,14,526,73,137,41,389,82,21402
2402,2402,15000US060952529101,428,87,15,19,8,15,7,12,413,89,112,70,301,73,21403
2403,2403,15000US060952529102,450,70,33,30,18,19,15,24,417,68,135,65,282,65,21404
2404,2404,15000US060952529103,718,109,10,12,3,6,7,11,708,109,197,82,511,104,21405
2405,2405,15000US060952529104,413,79,26,41,0,12,26,41,387,78,39,33,348,80,21406
2406,2406,15000US060952529111,950,145,100,76,12,19,88,77,850,142,291,113,559,151,21407
2407,2407,15000US060952529112,660,125,14,23,14,23,0,12,646,125,204,80,442,137,21408
2408,2408,15000US060952529113,239,75,0,12,0,12,0,12,239,75,46,41,193,85,21409
2409,2409,15000US060952529114,879,114,19,25,6,13,13,21,860,118,445,112,415,106,21410
2410,2410,15000US060952529121,442,77,21,33,21,33,0,12,421,73,115,54,306,73,21411
2411,2411,15000US060952529122,265,74,0,12,0,12,0,12,265,74,58,34,207,78,21412
2412,2412,15000US060952529123,359,87,0,12,0,12,0,12,359,87,56,40,303,90,21413
2413,2413,15000US060952529124,401,67,9,16,0,12,9,16,392,68,102,57,290,71,21414
2414,2414,15000US060952529125,369,63,0,12,0,12,0,12,369,63,84,38,285,72,21415
2415,2415,15000US060952529131,393,87,34,52,34,52,0,12,359,91,122,46,237,86,21416
2416,2416,15000US060952529132,416,83,16,21,16,21,0,12,400,85,97,52,303,95,21417
2417,2417,15000US060952529133,363,73,8,14,0,12,8,14,355,72,47,28,308,77,21418
2418,2418,15000US060952529134,456,88,9,13,9,13,0,12,447,91,50,31,397,91,21419
2419,2419,15000US060952529141,914,86,45,48,38,46,7,11,869,93,244,100,625,121,21420
2420,2420,15000US060952529142,486,114,19,28,19,28,0,12,467,114,95,54,372,99,21421
2421,2421,15000US060952529143,401,62,30,24,5,11,25,22,371,66,80,53,291,65,21422
2422,2422,15000US060952529151,433,82,23,19,13,20,10,16,410,83,81,44,329,80,21423
2423,2423,15000US060952529152,854,90,12,21,0,12,12,21,842,93,122,65,720,100,21424
2424,2424,15000US060952530001,0,17,0,17,0,17,0,17,0,17,0,17,0,17,21425
2425,2425,15000US060952531011,211,78,68,53,29,29,39,45,143,62,55,39,88,49,21426
2426,2426,15000US060952531012,229,71,64,50,0,12,64,50,165,59,86,52,79,34,21427
2427,2427,15000US060952531013,422,88,24,36,0,12,24,36,398,86,115,67,283,85,21428
2428,2428,15000US060952531014,291,69,8,11,0,12,8,11,283,69,106,54,177,71,21429
2429,2429,15000US060952531015,445,90,36,39,0,12,36,39,409,85,65,36,344,90,21430
2430,2430,15000US060952531016,449,64,68,52,54,51,14,16,381,73,143,57,238,74,21431
2431,2431,15000US060952531051,493,107,63,50,37,39,26,31,430,112,110,67,320,115,21432
2432,2432,15000US060952531052,878,169,16,26,0,12,16,26,862,172,217,103,645,168,21433
2433,2433,15000US060952531053,411,101,47,73,0,12,47,73,364,101,57,53,307,94,21434
2434,2434,15000US060952531054,295,88,66,73,0,12,66,73,229,103,67,64,162,89,21435
2435,2435,15000US060952531055,331,123,11,19,0,12,11,19,320,125,12,20,308,126,21436
2436,2436,15000US060952531061,350,86,0,12,0,12,0,12,350,86,77,60,273,82,21437
2437,2437,15000US060952531062,269,58,34,44,0,12,34,44,235,62,47,31,188,68,21438
2438,2438,15000US060952531063,640,93,27,24,14,12,13,21,613,90,75,34,538,93,21439
2439,2439,15000US060952531071,348,104,0,12,0,12,0,12,348,104,132,61,216,99,21440
2440,2440,15000US060952531072,833,165,16,24,0,12,16,24,817,163,105,88,712,174,21441
2441,2441,15000US060952531073,827,176,48,59,0,12,48,59,779,165,274,131,505,164,21442
2442,2442,15000US060952531074,317,118,60,48,49,44,11,20,257,113,62,49,195,112,21443
2443,2443,15000US060952531081,732,99,49,54,47,52,2,7,683,107,194,75,489,118,21444
2444,2444,15000US060952531082,450,97,33,26,7,12,26,23,417,98,91,52,326,94,21445
2445,2445,15000US060952531083,430,92,42,55,42,55,0,12,388,83,75,47,313,78,21446
2446,2446,15000US060952532011,470,59,20,22,0,12,20,22,450,62,115,52,335,63,21447
2447,2447,15000US060952532012,333,62,14,19,0,12,14,19,319,60,49,32,270,69,21448
2448,2448,15000US060952532013,486,81,9,14,9,14,0,12,477,81,141,64,336,82,21449
2449,2449,15000US060952532014,530,64,6,10,6,10,0,12,524,66,144,69,380,76,21450
2450,2450,15000US060952532031,489,84,74,52,17,21,57,53,415,75,61,43,354,82,21451
2451,2451,15000US060952532032,602,97,33,35,13,15,20,31,569,102,101,45,468,106,21452
2452,2452,15000US060952532033,338,71,11,19,0,12,11,19,327,72,79,38,248,71,21453
2453,2453,15000US060952532041,528,123,85,97,24,28,61,95,443,97,44,34,399,89,21454
2454,2454,15000US060952532042,305,83,0,12,0,12,0,12,305,83,73,72,232,81,21455
2455,2455,15000US060952532043,518,111,21,28,6,13,15,25,497,110,48,44,449,110,21456
2456,2456,15000US060952532044,384,129,70,57,34,38,36,42,314,134,57,55,257,134,21457
2457,2457,15000US060952532045,616,147,181,78,75,73,106,81,435,156,129,71,306,133,21458
2458,2458,15000US060952532051,414,76,0,12,0,12,0,12,414,76,55,33,359,76,21459
2459,2459,15000US060952532052,213,47,0,12,0,12,0,12,213,47,74,44,139,48,21460
2460,2460,15000US060952532053,363,89,146,75,17,25,129,73,217,69,49,31,168,73,21461
2461,2461,15000US060952532061,503,77,32,26,16,18,16,17,471,81,69,40,402,88,21462
2462,2462,15000US060952532062,502,73,23,22,15,18,8,12,479,73,40,24,439,78,21463
2463,2463,15000US060952533001,562,80,40,32,26,24,14,21,522,84,137,56,385,86,21464
2464,2464,15000US060952533002,351,64,7,10,1,3,6,10,344,64,55,41,289,66,21465
2465,2465,15000US060952534021,396,93,43,45,0,12,43,45,353,94,79,51,274,92,21466
2466,2466,15000US060952534022,222,105,15,23,0,12,15,23,207,109,144,98,63,44,21467
2467,2467,15000US060952534023,287,104,32,38,15,27,17,28,255,100,45,39,210,94,21468
2468,2468,15000US060952534024,806,149,118,99,47,74,71,64,688,160,195,97,493,157,21469
2469,2469,15000US060952534025,493,122,16,28,0,12,16,28,477,128,65,54,412,138,21470
2470,2470,15000US060952534031,427,87,12,18,0,12,12,18,415,83,93,40,322,79,21471
2471,2471,15000US060952534032,436,81,24,37,24,37,0,12,412,79,154,61,258,71,21472
2472,2472,15000US060952534033,658,84,8,12,8,12,0,12,650,84,162,62,488,88,21473
2473,2473,15000US060952534041,689,151,119,96,57,75,62,61,570,143,113,81,457,117,21474
2474,2474,15000US060952534042,488,122,193,101,67,66,126,105,295,94,102,61,193,102,21475
2475,2475,15000US060952534043,338,98,0,12,0,12,0,12,338,98,52,41,286,98,21476
2476,2476,15000US060952534044,676,154,103,98,12,22,91,94,573,132,127,79,446,123,21477
2477,2477,15000US060952535001,2552,233,65,51,17,25,48,46,2487,232,948,197,1539,216,21478
2478,2478,15000US060952535002,712,126,34,43,24,39,10,16,678,133,242,122,436,135,21479
2479,2479,15000US060952535003,572,131,63,60,38,45,25,39,509,126,76,63,433,122,21480
2480,2480,15000US060952535004,569,155,80,93,80,93,0,12,489,144,198,119,291,117,21481
2481,2481,15000US060959800001,0,12,0,12,0,12,0,12,0,12,0,12,0,12,21482
2482,2482,15000US060971501001,528,73,0,12,0,12,0,12,528,73,98,37,430,81,21483
2483,2483,15000US060971501002,333,61,7,11,0,12,7,11,326,63,66,35,260,64,21484
2484,2484,15000US060971501003,164,57,0,12,0,12,0,12,164,57,19,17,145,57,21485
2485,2485,15000US060971502021,440,108,0,12,0,12,0,12,440,108,104,75,336,118,21486
2486,2486,15000US060971502022,302,73,0,12,0,12,0,12,302,73,52,37,250,74,21487
2487,2487,15000US060971502023,250,72,0,12,0,12,0,12,250,72,28,34,222,70,21488
2488,2488,15000US060971502024,808,143,12,20,0,12,12,20,796,141,102,68,694,146,21489
2489,2489,15000US060971502025,548,99,0,12,0,12,0,12,548,99,45,47,503,100,21490
2490,2490,15000US060971502031,722,122,40,50,40,50,0,12,682,121,197,109,485,119,21491
2491,2491,15000US060971502032,644,149,0,12,0,12,0,12,644,149,193,87,451,147,21492
2492,2492,15000US060971502033,907,150,55,50,21,34,34,38,852,155,328,120,524,146,21493
2493,2493,15000US060971502041,462,75,14,14,9,14,5,10,448,72,75,48,373,80,21494
2494,2494,15000US060971502042,716,102,67,53,30,27,37,45,649,100,58,38,591,100,21495
2495,2495,15000US060971502043,563,75,0,12,0,12,0,12,563,75,69,40,494,80,21496
2496,2496,15000US060971503031,442,101,0,12,0,12,0,12,442,101,128,85,314,91,21497
2497,2497,15000US060971503032,449,101,0,12,0,12,0,12,449,101,74,62,375,105,21498
2498,2498,15000US060971503033,392,113,0,12,0,12,0,12,392,113,58,53,334,114,21499
2499,2499,15000US060971503034,1009,138,0,12,0,12,0,12,1009,138,317,135,692,147,21500
2500,2500,15000US060971503041,419,108,0,12,0,12,0,12,419,108,111,91,308,120,21501
2501,2501,15000US060971503042,692,141,58,64,35,50,23,38,634,130,93,56,541,132,21502
2502,2502,15000US060971503043,655,141,0,12,0,12,0,12,655,141,99,67,556,151,21503
2503,2503,15000US060971503044,416,105,16,25,0,12,16,25,400,103,95,65,305,97,21504
2504,2504,15000US060971503051,269,95,93,81,0,12,93,81,176,57,47,27,129,52,21505
2505,2505,15000US060971503052,495,116,16,24,16,24,0,12,479,117,97,53,382,116,21506
2506,2506,15000US060971503053,732,144,105,87,10,16,95,86,627,143,213,98,414,134,21507
2507,2507,15000US060971503054,293,101,15,23,0,12,15,23,278,100,80,66,198,87,21508
2508,2508,15000US060971503061,460,95,42,50,0,12,42,50,418,89,133,73,285,90,21509
2509,2509,15000US060971503062,492,101,52,51,5,9,47,50,440,90,107,61,333,81,21510
2510,2510,15000US060971503063,693,107,36,36,10,16,26,34,657,115,102,45,555,112,21511
2511,2511,15000US060971505001,129,125,0,12,0,12,0,12,129,125,0,12,129,125,21512
2512,2512,15000US060971505002,410,188,0,12,0,12,0,12,410,188,25,41,385,188,21513
2513,2513,15000US060971505003,618,157,0,12,0,12,0,12,618,157,133,112,485,120,21514
2514,2514,15000US060971505004,289,82,0,12,0,12,0,12,289,82,94,58,195,86,21515
2515,2515,15000US060971505005,352,112,18,28,0,12,18,28,334,118,47,43,287,120,21516
2516,2516,15000US060971505006,387,129,16,26,0,12,16,26,371,125,57,47,314,134,21517
2517,2517,15000US060971506011,358,63,7,11,0,12,7,11,351,64,58,49,293,68,21518
2518,2518,15000US060971506012,280,75,8,15,0,12,8,15,272,75,72,44,200,73,21519
2519,2519,15000US060971506013,479,77,53,56,0,12,53,56,426,83,39,36,387,83,21520
2520,2520,15000US060971506014,261,70,0,12,0,12,0,12,261,70,61,57,200,62,21521
2521,2521,15000US060971506021,445,73,10,15,0,12,10,15,435,75,88,47,347,82,21522
2522,2522,15000US060971506022,196,41,8,13,8,13,0,12,188,42,7,12,181,45,21523
2523,2523,15000US060971506023,433,57,8,12,0,12,8,12,425,60,103,54,322,66,21524
2524,2524,15000US060971506024,386,61,7,13,0,12,7,13,379,63,28,25,351,66,21525
2525,2525,15000US060971506031,704,126,29,34,0,12,29,34,675,130,180,74,495,123,21526
2526,2526,15000US060971506032,314,93,39,59,39,59,0,12,275,94,42,37,233,94,21527
2527,2527,15000US060971506033,219,86,11,19,11,19,0,12,208,92,22,34,186,86,21528
2528,2528,15000US060971506034,537,86,0,12,0,12,0,12,537,86,185,92,352,81,21529
2529,2529,15000US060971506035,377,87,32,42,23,37,9,16,345,98,46,58,299,94,21530
2530,2530,15000US060971506036,410,71,26,41,0,12,26,41,384,71,104,72,280,74,21531
2531,2531,15000US060971506071,366,71,0,12,0,12,0,12,366,71,51,33,315,80,21532
2532,2532,15000US060971506072,274,79,0,12,0,12,0,12,274,79,54,59,220,74,21533
2533,2533,15000US060971506073,1130,99,10,16,10,16,0,12,1120,99,209,67,911,91,21534
2534,2534,15000US060971506091,642,84,16,19,9,14,7,13,626,87,154,68,472,89,21535
2535,2535,15000US060971506092,523,77,44,33,23,23,21,24,479,76,180,61,299,83,21536
2536,2536,15000US060971506093,422,72,22,35,0,12,22,35,400,70,161,69,239,66,21537
2537,2537,15000US060971506094,361,75,23,32,0,12,23,32,338,77,110,63,228,62,21538
2538,2538,15000US060971506101,434,70,18,20,8,13,10,15,416,74,49,28,367,79,21539
2539,2539,15000US060971506102,670,67,7,11,0,12,7,11,663,69,107,55,556,74,21540
2540,2540,15000US060971506103,255,52,18,20,0,12,18,20,237,52,62,45,175,52,21541
2541,2541,15000US060971506111,1029,82,88,61,49,49,39,46,941,84,187,83,754,111,21542
2542,2542,15000US060971506112,296,62,0,12,0,12,0,12,296,62,41,24,255,60,21543
2543,2543,15000US060971506113,222,45,0,12,0,12,0,12,222,45,57,44,165,46,21544
2544,2544,15000US060971506121,981,82,24,28,13,21,11,18,957,77,148,57,809,77,21545
2545,2545,15000US060971506122,646,101,32,51,32,51,0,12,614,102,198,77,416,89,21546
2546,2546,15000US060971507011,632,89,105,108,87,105,18,27,527,144,115,70,412,135,21547
2547,2547,15000US060971507012,632,143,0,12,0,12,0,12,632,143,120,77,512,136,21548
2548,2548,15000US060971507013,491,106,0,12,0,12,0,12,491,106,49,51,442,110,21549
2549,2549,15000US060971507014,306,83,31,48,0,12,31,48,275,67,30,34,245,73,21550
2550,2550,15000US060971507021,533,82,23,36,0,12,23,36,510,76,64,35,446,76,21551
2551,2551,15000US060971507022,307,59,23,36,0,12,23,36,284,55,17,20,267,57,21552
2552,2552,15000US060971507023,529,68,40,43,8,13,32,41,489,70,51,27,438,78,21553
2553,2553,15000US060971507024,450,86,41,53,0,12,41,53,409,86,73,49,336,88,21554
2554,2554,15000US060971508001,393,61,0,12,0,12,0,12,393,61,37,27,356,66,21555
2555,2555,15000US060971508002,472,87,9,14,0,12,9,14,463,86,104,59,359,76,21556
2556,2556,15000US060971508003,378,56,18,20,9,14,9,14,360,60,36,29,324,57,21557
2557,2557,15000US060971508004,765,78,19,22,0,12,19,22,746,78,198,77,548,93,21558
2558,2558,15000US060971509011,371,107,15,22,0,12,15,22,356,105,60,43,296,107,21559
2559,2559,15000US060971509012,355,105,13,22,13,22,0,12,342,102,75,60,267,113,21560
2560,2560,15000US060971509013,421,101,15,25,0,12,15,25,406,102,51,48,355,99,21561
2561,2561,15000US060971509014,355,95,29,35,0,12,29,35,326,109,47,41,279,111,21562
2562,2562,15000US060971509015,500,133,53,42,39,43,14,23,447,139,148,93,299,126,21563
2563,2563,15000US060971509021,446,69,17,16,7,11,10,12,429,67,111,38,318,74,21564
2564,2564,15000US060971509022,331,57,0,12,0,12,0,12,331,57,68,44,263,53,21565
2565,2565,15000US060971509023,379,61,0,12,0,12,0,12,379,61,66,31,313,66,21566
2566,2566,15000US060971509024,241,52,7,12,7,12,0,12,234,51,27,21,207,52,21567
2567,2567,15000US060971510001,421,66,20,19,0,12,20,19,401,66,104,41,297,65,21568
2568,2568,15000US060971510002,524,75,37,57,37,57,0,12,487,69,123,43,364,75,21569
2569,2569,15000US060971510003,567,81,42,43,11,16,31,39,525,85,99,57,426,93,21570
2570,2570,15000US060971511001,634,74,16,18,0,12,16,18,618,71,186,52,432,58,21571
2571,2571,15000US060971511002,818,74,16,13,5,8,11,11,802,73,109,41,693,78,21572
2572,2572,15000US060971511003,439,55,28,36,0,12,28,36,411,55,93,37,318,55,21573
2573,2573,15000US060971512011,583,149,45,48,27,39,18,29,538,148,160,109,378,143,21574
2574,2574,15000US060971512012,338,80,0,12,0,12,0,12,338,80,126,72,212,78,21575
2575,2575,15000US060971512013,390,146,74,87,16,27,58,83,316,139,83,73,233,119,21576
2576,2576,15000US060971512014,757,139,62,76,0,12,62,76,695,137,144,70,551,136,21577
2577,2577,15000US060971512015,731,132,118,114,27,32,91,109,613,137,190,84,423,137,21578
2578,2578,15000US060971512031,406,86,39,32,9,14,30,36,367,86,68,50,299,83,21579
2579,2579,15000US060971512032,528,68,9,14,9,14,0,12,519,68,106,62,413,71,21580
2580,2580,15000US060971512033,347,63,18,20,0,12,18,20,329,61,98,41,231,64,21581
2581,2581,15000US060971512034,615,80,75,51,37,44,38,30,540,89,168,78,372,76,21582
2582,2582,15000US060971512041,625,101,26,38,0,12,26,38,599,101,84,44,515,101,21583
2583,2583,15000US060971512042,432,87,37,27,20,22,17,20,395,86,48,49,347,80,21584
2584,2584,15000US060971512043,269,70,5,9,5,9,0,12,264,70,49,32,215,77,21585
2585,2585,15000US060971513011,602,92,66,52,11,17,55,51,536,87,70,42,466,96,21586
2586,2586,15000US060971513012,366,65,48,32,32,27,16,18,318,64,76,52,242,62,21587
2587,2587,15000US060971513013,631,90,86,56,35,33,51,46,545,95,88,60,457,98,21588
2588,2588,15000US060971513051,1099,159,116,78,38,37,78,75,983,163,375,143,608,150,21589
2589,2589,15000US060971513052,233,86,28,45,0,12,28,45,205,72,15,23,190,70,21590
2590,2590,15000US060971513053,633,123,66,52,35,37,31,37,567,127,82,69,485,136,21591
2591,2591,15000US060971513054,401,128,77,70,35,47,42,53,324,124,88,80,236,108,21592
2592,2592,15000US060971513061,144,49,9,14,0,12,9,14,135,54,30,22,105,52,21593
2593,2593,15000US060971513062,302,67,0,12,0,12,0,12,302,67,31,22,271,73,21594
2594,2594,15000US060971513063,484,88,28,26,9,16,19,23,456,90,74,40,382,90,21595
2595,2595,15000US060971513064,620,88,83,58,37,33,46,50,537,91,203,74,334,79,21596
2596,2596,15000US060971513071,668,83,72,52,35,29,37,47,596,76,103,51,493,82,21597
2597,2597,15000US060971513072,404,75,8,13,0,12,8,13,396,76,51,34,345,83,21598
2598,2598,15000US060971513073,438,63,11,16,11,16,0,12,427,66,68,32,359,73,21599
2599,2599,15000US060971513074,448,84,50,61,0,12,50,61,398,72,58,38,340,78,21600
2600,2600,15000US060971513081,216,64,37,54,0,12,37,54,179,60,27,31,152,58,21601
2601,2601,15000US060971513082,764,135,90,90,90,90,0,12,674,136,189,85,485,154,21602
2602,2602,15000US060971513083,280,68,0,12,0,12,0,12,280,68,51,46,229,75,21603
2603,2603,15000US060971513084,149,51,0,12,0,12,0,12,149,51,82,46,67,51,21604
2604,2604,15000US060971513085,505,97,43,54,11,22,32,49,462,88,100,60,362,80,21605
2605,2605,15000US060971513091,371,82,0,12,0,12,0,12,371,82,61,33,310,82,21606
2606,2606,15000US060971513092,918,99,70,55,12,18,58,52,848,116,118,65,730,120,21607
2607,2607,15000US060971513093,679,103,46,48,12,19,34,44,633,117,175,81,458,95,21608
2608,2608,15000US060971513101,224,49,6,9,6,9,0,12,218,47,25,18,193,48,21609
2609,2609,15000US060971513102,567,85,8,12,0,12,8,12,559,85,200,81,359,90,21610
2610,2610,15000US060971513103,465,104,70,65,34,50,36,44,395,83,68,40,327,83,21611
2611,2611,15000US060971513104,235,85,0,12,0,12,0,12,235,85,12,16,223,87,21612
2612,2612,15000US060971513111,427,88,0,12,0,12,0,12,427,88,134,72,293,94,21613
2613,2613,15000US060971513112,520,132,29,32,15,25,14,22,491,135,39,45,452,135,21614
2614,2614,15000US060971513113,502,139,23,35,0,12,23,35,479,136,88,64,391,128,21615
2615,2615,15000US060971513114,431,101,0,12,0,12,0,12,431,101,40,44,391,99,21616
2616,2616,15000US060971513115,392,110,0,12,0,12,0,12,392,110,26,32,366,112,21617
2617,2617,15000US060971514011,1647,179,175,94,76,61,99,73,1472,183,202,89,1270,197,21618
2618,2618,15000US060971514012,459,118,105,95,71,88,34,37,354,104,113,70,241,93,21619
2619,2619,15000US060971514013,313,106,17,27,17,27,0,12,296,109,87,81,209,94,21620
2620,2620,15000US060971514021,863,161,90,73,51,41,39,56,773,152,184,83,589,144,21621
2621,2621,15000US060971514022,741,125,101,87,26,32,75,82,640,116,147,86,493,116,21622
2622,2622,15000US060971514023,845,138,102,89,22,28,80,82,743,132,237,122,506,127,21623
2623,2623,15000US060971514024,204,90,47,46,0,12,47,46,157,80,5,13,152,81,21624
2624,2624,15000US060971514025,676,118,75,56,44,56,31,48,601,128,109,84,492,132,21625
2625,2625,15000US060971515021,818,154,34,38,34,38,0,12,784,156,138,75,646,164,21626
2626,2626,15000US060971515022,235,58,0,12,0,12,0,12,235,58,41,31,194,59,21627
2627,2627,15000US060971515023,317,99,0,12,0,12,0,12,317,99,30,25,287,109,21628
2628,2628,15000US060971515024,202,78,0,12,0,12,0,12,202,78,60,44,142,78,21629
2629,2629,15000US060971515025,560,117,77,78,0,12,77,78,483,128,110,93,373,116,21630
2630,2630,15000US060971515026,845,157,60,69,0,12,60,69,785,148,196,86,589,151,21631
2631,2631,15000US060971515031,524,65,0,12,0,12,0,12,524,65,119,55,405,66,21632
2632,2632,15000US060971515032,339,46,10,15,0,12,10,15,329,46,57,36,272,52,21633
2633,2633,15000US060971515033,514,66,0,12,0,12,0,12,514,66,82,37,432,67,21634
2634,2634,15000US060971515041,415,75,14,17,5,9,9,15,401,74,44,29,357,76,21635
2635,2635,15000US060971515042,432,65,22,24,0,12,22,24,410,68,56,33,354,74,21636
2636,2636,15000US060971515043,469,55,11,20,0,12,11,20,458,55,96,46,362,67,21637
2637,2637,15000US060971516011,402,51,6,9,6,9,0,12,396,52,129,44,267,58,21638
2638,2638,15000US060971516012,614,69,31,39,7,12,24,37,583,70,205,61,378,71,21639
2639,2639,15000US060971516013,664,64,7,12,0,12,7,12,657,62,223,56,434,64,21640
2640,2640,15000US060971516021,531,83,6,9,0,12,6,9,525,83,187,72,338,87,21641
2641,2641,15000US060971516022,577,74,0,12,0,12,0,12,577,74,177,68,400,77,21642
2642,2642,15000US060971516023,753,87,14,20,14,20,0,12,739,88,210,62,529,102,21643
2643,2643,15000US060971517001,180,81,0,12,0,12,0,12,180,81,15,26,165,76,21644
2644,2644,15000US060971517002,266,74,0,12,0,12,0,12,266,74,31,38,235,68,21645
2645,2645,15000US060971517003,536,105,83,71,45,57,38,44,453,108,16,26,437,110,21646
2646,2646,15000US060971517004,721,118,72,78,0,12,72,78,649,94,185,70,464,105,21647
2647,2647,15000US060971517005,435,87,50,46,19,29,31,36,385,90,88,60,297,79,21648
2648,2648,15000US060971517006,559,130,86,102,25,39,61,95,473,126,247,100,226,110,21649
2649,2649,15000US060971518001,455,85,32,38,0,12,32,38,423,83,72,51,351,90,21650
2650,2650,15000US060971518002,263,85,25,40,0,12,25,40,238,78,97,79,141,56,21651
2651,2651,15000US060971518003,399,119,0,12,0,12,0,12,399,119,62,73,337,102,21652
2652,2652,15000US060971518004,732,126,92,63,53,51,39,48,640,125,178,113,462,115,21653
2653,2653,15000US060971518005,199,50,0,12,0,12,0,12,199,50,13,23,186,50,21654
2654,2654,15000US060971519001,339,88,0,12,0,12,0,12,339,88,119,83,220,62,21655
2655,2655,15000US060971519002,287,82,37,31,0,12,37,31,250,84,59,52,191,68,21656
2656,2656,15000US060971519003,291,68,65,46,9,11,56,45,226,60,73,40,153,49,21657
2657,2657,15000US060971519004,481,87,76,51,52,47,24,22,405,94,114,46,291,96,21658
2658,2658,15000US060971520001,462,68,30,19,14,15,16,12,432,68,107,37,325,73,21659
2659,2659,15000US060971520002,458,60,20,16,11,11,9,11,438,60,74,42,364,62,21660
2660,2660,15000US060971521001,369,92,69,49,49,49,20,25,300,84,69,41,231,87,21661
2661,2661,15000US060971521002,288,85,10,17,10,17,0,12,278,85,40,24,238,85,21662
2662,2662,15000US060971521003,396,77,18,21,12,18,6,11,378,77,52,45,326,86,21663
2663,2663,15000US060971522011,458,65,32,37,9,13,23,34,426,67,97,42,329,72,21664
2664,2664,15000US060971522012,358,73,20,30,20,30,0,12,338,74,56,30,282,80,21665
2665,2665,15000US060971522013,510,78,85,62,56,40,29,46,425,82,115,56,310,67,21666
2666,2666,15000US060971522014,361,87,83,50,38,38,45,32,278,79,9,13,269,79,21667
2667,2667,15000US060971522021,253,89,0,12,0,12,0,12,253,89,15,24,238,92,21668
2668,2668,15000US060971522022,967,152,28,35,28,35,0,12,939,151,309,145,630,155,21669
2669,2669,15000US060971522023,571,101,13,22,13,22,0,12,558,101,97,82,461,108,21670
2670,2670,15000US060971522024,445,135,12,21,0,12,12,21,433,137,107,81,326,134,21671
2671,2671,15000US060971522025,502,115,0,12,0,12,0,12,502,115,150,72,352,126,21672
2672,2672,15000US060971522031,274,60,8,14,8,14,0,12,266,61,20,19,246,63,21673
2673,2673,15000US060971522032,373,74,13,15,13,15,0,12,360,73,35,29,325,76,21674
2674,2674,15000US060971522033,584,103,43,34,24,29,19,20,541,105,204,76,337,89,21675
2675,2675,15000US060971522034,579,80,115,69,75,54,40,42,464,88,59,40,405,92,21676
2676,2676,15000US060971523001,617,78,10,15,0,12,10,15,607,80,213,77,394,70,21677
2677,2677,15000US060971523002,369,59,7,11,0,12,7,11,362,60,99,52,263,52,21678
2678,2678,15000US060971523003,519,59,33,25,9,13,24,22,486,64,91,41,395,69,21679
2679,2679,15000US060971523004,313,50,10,16,0,12,10,16,303,51,54,30,249,58,21680
2680,2680,15000US060971524001,868,220,0,12,0,12,0,12,868,220,300,183,568,167,21681
2681,2681,15000US060971524002,798,210,0,12,0,12,0,12,798,210,303,174,495,146,21682
2682,2682,15000US060971524003,979,195,0,12,0,12,0,12,979,195,246,125,733,220,21683
2683,2683,15000US060971524004,1005,180,16,23,0,12,16,23,989,180,226,146,763,166,21684
2684,2684,15000US060971524005,637,108,0,12,0,12,0,12,637,108,85,73,552,127,21685
2685,2685,15000US060971525011,768,112,0,12,0,12,0,12,768,112,126,54,642,108,21686
2686,2686,15000US060971525012,518,76,79,46,38,27,41,44,439,81,77,51,362,79,21687
2687,2687,15000US060971525013,385,77,55,44,20,33,35,25,330,80,46,25,284,79,21688
2688,2688,15000US060971525021,542,79,11,17,0,12,11,17,531,79,43,26,488,81,21689
2689,2689,15000US060971525022,617,102,10,15,0,12,10,15,607,102,143,81,464,105,21690
2690,2690,15000US060971525023,354,57,16,18,6,10,10,15,338,58,146,47,192,63,21691
2691,2691,15000US060971526001,613,110,0,12,0,12,0,12,613,110,109,66,504,119,21692
2692,2692,15000US060971526002,854,117,19,23,0,12,19,23,835,120,211,84,624,117,21693
2693,2693,15000US060971526003,475,86,15,24,15,24,0,12,460,91,90,64,370,109,21694
2694,2694,15000US060971526004,450,106,0,12,0,12,0,12,450,106,105,76,345,95,21695
2695,2695,15000US060971526005,540,110,29,34,13,22,16,25,511,111,91,57,420,111,21696
2696,2696,15000US060971526006,244,64,0,12,0,12,0,12,244,64,47,39,197,73,21697
2697,2697,15000US060971527011,423,101,46,70,46,70,0,12,377,87,105,58,272,81,21698
2698,2698,15000US060971527012,366,87,97,70,18,28,79,62,269,89,34,37,235,98,21699
2699,2699,15000US060971527013,375,81,0,12,0,12,0,12,375,81,106,80,269,75,21700
2700,2700,15000US060971527014,418,130,108,85,0,12,108,85,310,121,26,29,284,124,21701
2701,2701,15000US060971527015,578,90,65,52,43,44,22,26,513,95,139,66,374,99,21702
2702,2702,15000US060971527021,127,60,39,51,0,12,39,51,88,51,63,54,25,19,21703
2703,2703,15000US060971527022,471,88,25,26,9,14,16,21,446,90,167,68,279,69,21704
2704,2704,15000US060971527023,389,76,8,12,0,12,8,12,381,77,90,67,291,68,21705
2705,2705,15000US060971527024,864,127,126,66,0,12,126,66,738,108,231,100,507,100,21706
2706,2706,15000US060971527025,240,65,0,12,0,12,0,12,240,65,61,37,179,70,21707
2707,2707,15000US060971528011,538,106,87,68,37,28,50,64,451,98,115,69,336,91,21708
2708,2708,15000US060971528012,403,71,9,14,9,14,0,12,394,73,32,28,362,75,21709
2709,2709,15000US060971528013,443,104,18,28,0,12,18,28,425,97,50,36,375,88,21710
2710,2710,15000US060971528014,249,77,0,12,0,12,0,12,249,77,35,40,214,79,21711
2711,2711,15000US060971528015,316,53,19,20,19,20,0,12,297,56,69,44,228,58,21712
2712,2712,15000US060971528021,479,118,86,70,45,54,41,40,393,109,195,95,198,84,21713
2713,2713,15000US060971528022,822,181,109,100,35,40,74,91,713,187,237,126,476,136,21714
2714,2714,15000US060971528023,424,110,0,12,0,12,0,12,424,110,29,36,395,121,21715
2715,2715,15000US060971528024,593,135,93,83,0,12,93,83,500,121,180,79,320,114,21716
2716,2716,15000US060971528025,457,135,33,55,0,12,33,55,424,129,108,87,316,107,21717
2717,2717,15000US060971529031,276,78,7,12,0,12,7,12,269,78,138,78,131,45,21718
2718,2718,15000US060971529032,624,99,109,58,34,39,75,45,515,101,129,66,386,96,21719
2719,2719,15000US060971529033,308,103,121,83,0,12,121,83,187,86,91,71,96,60,21720
2720,2720,15000US060971529034,282,78,79,61,45,44,34,42,203,69,43,42,160,59,21721
2721,2721,15000US060971529041,832,95,84,64,31,35,53,56,748,102,132,51,616,114,21722
2722,2722,15000US060971529042,281,59,0,12,0,12,0,12,281,59,83,50,198,52,21723
2723,2723,15000US060971529043,464,69,32,38,9,14,23,34,432,74,105,44,327,79,21724
2724,2724,15000US060971529044,399,69,0,12,0,12,0,12,399,69,93,39,306,71,21725
2725,2725,15000US060971529051,490,81,23,25,13,17,10,20,467,78,148,62,319,85,21726
2726,2726,15000US060971529052,644,111,17,19,7,11,10,16,627,112,174,69,453,117,21727
2727,2727,15000US060971529053,447,97,49,49,6,8,43,48,398,111,39,27,359,116,21728
2728,2728,15000US060971529061,1297,118,30,26,17,20,13,17,1267,120,189,62,1078,125,21729
2729,2729,15000US060971529062,780,112,10,16,0,12,10,16,770,113,188,70,582,118,21730
2730,2730,15000US060971530011,765,179,183,135,103,114,80,75,582,148,201,98,381,134,21731
2731,2731,15000US060971530012,537,102,48,51,25,38,23,36,489,98,164,86,325,107,21732
2732,2732,15000US060971530013,1188,160,266,128,103,69,163,98,922,166,204,83,718,176,21733
2733,2733,15000US060971530021,593,127,168,105,41,34,127,103,425,108,83,47,342,112,21734
2734,2734,15000US060971530022,455,113,59,60,0,12,59,60,396,89,121,76,275,76,21735
2735,2735,15000US060971530023,284,87,0,12,0,12,0,12,284,87,33,27,251,88,21736
2736,2736,15000US060971530024,407,126,87,73,67,69,20,24,320,103,62,50,258,98,21737
2737,2737,15000US060971530025,174,57,11,18,11,18,0,12,163,59,21,23,142,66,21738
2738,2738,15000US060971530031,291,81,59,44,12,18,47,41,232,70,74,43,158,60,21739
2739,2739,15000US060971530032,325,99,91,64,50,36,41,51,234,83,64,40,170,81,21740
2740,2740,15000US060971530033,719,126,122,82,42,43,80,70,597,127,89,48,508,118,21741
2741,2741,15000US060971530034,693,111,78,44,19,19,59,42,615,116,116,50,499,118,21742
2742,2742,15000US060971530051,397,107,18,28,18,28,0,12,379,105,67,46,312,97,21743
2743,2743,15000US060971530052,313,99,0,12,0,12,0,12,313,99,88,96,225,92,21744
2744,2744,15000US060971530053,523,91,0,12,0,12,0,12,523,91,163,79,360,95,21745
2745,2745,15000US060971530054,240,77,0,12,0,12,0,12,240,77,37,42,203,84,21746
2746,2746,15000US060971530055,564,111,8,17,8,17,0,12,556,111,147,87,409,117,21747
2747,2747,15000US060971530056,433,124,0,12,0,12,0,12,433,124,48,41,385,129,21748
2748,2748,15000US060971530061,276,60,16,25,0,12,16,25,260,64,93,47,167,62,21749
2749,2749,15000US060971530062,251,70,32,40,32,40,0,12,219,73,33,37,186,70,21750
2750,2750,15000US060971530063,423,106,47,47,20,33,27,34,376,102,17,28,359,103,21751
2751,2751,15000US060971530064,928,145,143,101,28,42,115,91,785,125,239,111,546,113,21752
2752,2752,15000US060971530065,351,122,75,83,0,12,75,83,276,139,52,38,224,138,21753
2753,2753,15000US060971530066,601,116,40,47,18,29,22,35,561,115,220,142,341,106,21754
2754,2754,15000US060971531021,363,74,83,59,49,45,34,41,280,67,67,52,213,72,21755
2755,2755,15000US060971531022,493,123,93,75,10,17,83,73,400,126,124,73,276,112,21756
2756,2756,15000US060971531023,310,76,41,39,36,37,5,14,269,68,21,20,248,69,21757
2757,2757,15000US060971531024,287,82,30,30,22,25,8,15,257,86,75,53,182,78,21758
2758,2758,15000US060971531031,694,94,143,63,60,45,83,44,551,91,80,38,471,93,21759
2759,2759,15000US060971531032,456,77,50,34,16,16,34,30,406,83,69,53,337,73,21760
2760,2760,15000US060971531033,259,83,129,77,38,40,91,70,130,39,54,31,76,38,21761
2761,2761,15000US060971531041,615,86,164,66,76,56,88,66,451,84,75,49,376,88,21762
2762,2762,15000US060971531042,104,46,11,17,11,17,0,12,93,49,10,15,83,48,21763
2763,2763,15000US060971531043,457,86,160,85,68,62,92,68,297,88,112,60,185,83,21764
2764,2764,15000US060971532001,398,146,64,74,52,74,12,20,334,150,111,71,223,125,21765
2765,2765,15000US060971532002,382,139,43,48,13,23,30,44,339,141,84,61,255,164,21766
2766,2766,15000US060971532003,535,160,108,92,23,28,85,89,427,155,118,76,309,153,21767
2767,2767,15000US060971532004,1208,163,185,111,123,86,62,68,1023,175,293,124,730,177,21768
2768,2768,15000US060971533001,1138,176,63,80,18,31,45,73,1075,174,263,131,812,159,21769
2769,2769,15000US060971533002,263,95,43,36,27,34,16,26,220,90,101,77,119,64,21770
2770,2770,15000US060971533003,566,129,16,24,16,24,0,12,550,131,224,110,326,136,21771
2771,2771,15000US060971533004,1716,192,271,155,61,41,210,155,1445,206,282,120,1163,223,21772
2772,2772,15000US060971534011,259,95,9,16,9,16,0,12,250,99,67,52,183,86,21773
2773,2773,15000US060971534012,634,132,36,40,21,33,15,25,598,136,90,51,508,139,21774
2774,2774,15000US060971534013,440,101,11,17,0,12,11,17,429,102,160,72,269,93,21775
2775,2775,15000US060971534014,590,114,0,12,0,12,0,12,590,114,111,66,479,126,21776
2776,2776,15000US060971534015,430,113,13,20,0,12,13,20,417,113,66,50,351,113,21777
2777,2777,15000US060971534016,525,119,49,63,35,56,14,23,476,111,101,69,375,100,21778
2778,2778,15000US060971534031,569,93,40,37,4,7,36,37,529,92,128,49,401,97,21779
2779,2779,15000US060971534032,403,73,17,13,8,13,9,14,386,71,123,62,263,64,21780
2780,2780,15000US060971534033,286,53,19,28,19,28,0,12,267,61,26,20,241,64,21781
2781,2781,15000US060971534034,298,67,0,12,0,12,0,12,298,67,41,26,257,63,21782
2782,2782,15000US060971534041,383,62,11,17,0,12,11,17,372,62,73,38,299,71,21783
2783,2783,15000US060971534042,610,72,87,45,57,39,30,28,523,77,185,81,338,66,21784
2784,2784,15000US060971534043,325,78,0,12,0,12,0,12,325,78,62,38,263,86,21785
2785,2785,15000US060971534044,526,75,12,18,12,18,0,12,514,75,89,40,425,80,21786
2786,2786,15000US060971535011,471,93,12,17,0,12,12,17,459,95,118,72,341,86,21787
2787,2787,15000US060971535012,469,80,37,31,8,15,29,27,432,77,113,49,319,80,21788
2788,2788,15000US060971535013,445,76,0,12,0,12,0,12,445,76,82,41,363,76,21789
2789,2789,15000US060971535014,567,75,16,18,16,18,0,12,551,76,157,66,394,72,21790
2790,2790,15000US060971535021,378,64,0,12,0,12,0,12,378,64,41,30,337,65,21791
2791,2791,15000US060971535022,301,61,11,20,11,20,0,12,290,59,56,35,234,64,21792
2792,2792,15000US060971535023,392,82,0,12,0,12,0,12,392,82,61,40,331,78,21793
2793,2793,15000US060971535024,622,96,0,12,0,12,0,12,622,96,179,78,443,113,21794
2794,2794,15000US060971536001,315,83,18,29,0,12,18,29,297,83,98,52,199,79,21795
2795,2795,15000US060971536002,457,116,0,12,0,12,0,12,457,116,141,91,316,115,21796
2796,2796,15000US060971536003,408,119,18,17,9,15,9,17,390,120,98,82,292,108,21797
2797,2797,15000US060971536004,352,74,53,52,53,52,0,12,299,65,120,61,179,67,21798
2798,2798,15000US060971536005,818,159,43,40,14,22,29,33,775,164,152,96,623,164,21799
2799,2799,15000US060971537031,498,90,73,53,31,34,42,41,425,69,78,45,347,67,21800
2800,2800,15000US060971537032,324,88,23,27,10,16,13,22,301,86,112,57,189,62,21801
2801,2801,15000US060971537033,279,63,30,25,21,20,9,13,249,65,73,35,176,65,21802
2802,2802,15000US060971537034,202,68,24,27,0,12,24,27,178,67,11,15,167,69,21803
2803,2803,15000US060971537035,347,81,0,12,0,12,0,12,347,81,110,60,237,81,21804
2804,2804,15000US060971537041,290,83,36,43,11,18,25,40,254,79,121,60,133,54,21805
2805,2805,15000US060971537042,324,96,78,60,25,24,53,55,246,92,105,46,141,93,21806
2806,2806,15000US060971537043,333,88,46,29,16,18,30,27,287,85,72,48,215,73,21807
2807,2807,15000US060971537044,740,138,149,93,66,68,83,65,591,126,193,88,398,110,21808
2808,2808,15000US060971537051,333,86,113,72,24,25,89,70,220,73,26,23,194,70,21809
2809,2809,15000US060971537052,338,55,8,13,8,13,0,12,330,56,122,50,208,49,21810
2810,2810,15000US060971537053,609,102,69,61,41,52,28,27,540,109,168,87,372,93,21811
2811,2811,15000US060971537054,465,70,12,18,12,18,0,12,453,72,131,56,322,78,21812
2812,2812,15000US060971537061,379,87,31,28,9,14,22,24,348,91,94,61,254,82,21813
2813,2813,15000US060971537062,536,83,44,56,0,12,44,56,492,68,109,46,383,68,21814
2814,2814,15000US060971537063,679,111,39,33,21,24,18,22,640,110,154,65,486,98,21815
2815,2815,15000US060971537064,334,75,18,21,18,21,0,12,316,75,84,39,232,73,21816
2816,2816,15000US060971538011,471,108,56,95,56,95,0,12,415,108,174,118,241,85,21817
2817,2817,15000US060971538012,1695,151,39,32,19,27,20,33,1656,147,251,115,1405,178,21818
2818,2818,15000US060971538013,361,104,0,12,0,12,0,12,361,104,173,97,188,93,21819
2819,2819,15000US060971538014,605,102,102,90,58,68,44,67,503,112,123,70,380,101,21820
2820,2820,15000US060971538041,675,71,0,12,0,12,0,12,675,71,209,58,466,94,21821
2821,2821,15000US060971538042,510,74,15,17,8,14,7,11,495,76,113,52,382,78,21822
2822,2822,15000US060971538061,286,58,9,14,9,14,0,12,277,60,52,32,225,63,21823
2823,2823,15000US060971538062,425,55,11,17,0,12,11,17,414,54,92,55,322,68,21824
2824,2824,15000US060971538063,587,67,17,27,0,12,17,27,570,70,117,51,453,82,21825
2825,2825,15000US060971538071,394,58,0,12,0,12,0,12,394,58,67,56,327,64,21826
2826,2826,15000US060971538072,984,73,29,26,19,20,10,15,955,72,126,56,829,89,21827
2827,2827,15000US060971538081,613,117,51,53,36,50,15,17,562,108,160,72,402,89,21828
2828,2828,15000US060971538082,395,95,85,62,57,57,28,26,310,101,78,67,232,84,21829
2829,2829,15000US060971538083,474,85,66,46,30,23,36,42,408,84,81,48,327,80,21830
2830,2830,15000US060971538091,533,80,0,12,0,12,0,12,533,80,66,42,467,81,21831
2831,2831,15000US060971538092,653,77,68,53,11,18,57,49,585,80,104,53,481,82,21832
2832,2832,15000US060971538093,391,59,0,12,0,12,0,12,391,59,102,50,289,66,21833
2833,2833,15000US060971539011,450,114,0,12,0,12,0,12,450,114,29,33,421,115,21834
2834,2834,15000US060971539012,546,90,17,25,17,25,0,12,529,90,196,87,333,101,21835
2835,2835,15000US060971539013,790,99,51,49,0,12,51,49,739,102,238,109,501,127,21836
2836,2836,15000US060971539014,342,92,0,12,0,12,0,12,342,92,64,45,278,105,21837
2837,2837,15000US060971539021,652,93,90,57,47,42,43,50,562,105,72,37,490,107,21838
2838,2838,15000US060971539022,273,73,35,34,3,9,32,33,238,68,90,56,148,57,21839
2839,2839,15000US060971539023,393,81,0,12,0,12,0,12,393,81,92,50,301,85,21840
2840,2840,15000US060971539024,399,81,33,41,27,39,6,11,366,90,52,44,314,86,21841
2841,2841,15000US060971539031,366,68,0,12,0,12,0,12,366,68,97,45,269,63,21842
2842,2842,15000US060971539032,467,91,3,7,0,12,3,7,464,90,64,45,400,107,21843
2843,2843,15000US060971539033,275,59,4,7,4,7,0,12,271,59,43,30,228,60,21844
2844,2844,15000US060971539034,582,89,0,12,0,12,0,12,582,89,145,62,437,87,21845
2845,2845,15000US060971540001,227,45,16,19,14,19,2,4,211,42,50,24,161,40,21846
2846,2846,15000US060971540002,302,64,12,18,3,6,9,16,290,60,105,49,185,41,21847
2847,2847,15000US060971540003,518,83,0,12,0,12,0,12,518,83,136,62,382,84,21848
2848,2848,15000US060971541001,254,62,14,19,0,12,14,19,240,62,102,57,138,47,21849
2849,2849,15000US060971541002,459,80,13,12,0,12,13,12,446,79,84,42,362,68,21850
2850,2850,15000US060971541003,345,84,37,45,28,43,9,13,308,75,92,45,216,65,21851
2851,2851,15000US060971541004,324,84,3,4,0,12,3,4,321,84,89,50,232,77,21852
2852,2852,15000US060971542011,471,92,66,42,46,33,20,24,405,86,150,77,255,62,21853
2853,2853,15000US060971542012,259,67,22,24,22,24,0,12,237,65,66,43,171,65,21854
2854,2854,15000US060971542013,220,77,67,59,23,36,44,53,153,65,22,23,131,67,21855
2855,2855,15000US060971542014,399,98,88,55,67,53,21,24,311,86,105,64,206,79,21856
2856,2856,15000US060971542021,1656,155,43,38,26,29,17,27,1613,150,382,133,1231,182,21857
2857,2857,15000US060971542022,385,77,14,22,14,22,0,12,371,82,147,78,224,75,21858
2858,2858,15000US060971542023,223,61,11,18,11,18,0,12,212,62,83,44,129,59,21859
2859,2859,15000US060971543021,391,111,0,12,0,12,0,12,391,111,47,50,344,115,21860
2860,2860,15000US060971543022,464,110,20,22,0,12,20,22,444,111,109,60,335,103,21861
2861,2861,15000US060971543023,417,104,0,12,0,12,0,12,417,104,73,55,344,106,21862
2862,2862,15000US060971543024,335,133,19,22,9,15,10,16,316,131,10,15,306,130,21863
2863,2863,15000US060971543031,296,81,15,22,0,12,15,22,281,78,47,21,234,74,21864
2864,2864,15000US060971543032,462,105,0,12,0,12,0,12,462,105,133,62,329,94,21865
2865,2865,15000US060971543041,332,71,20,16,2,3,18,16,312,67,38,18,274,64,21866
2866,2866,15000US060971543042,264,54,11,14,0,12,11,14,253,52,76,31,177,46,21867
2867,2867,15000US060971543043,362,78,20,23,14,21,6,9,342,75,46,38,296,73,21868
2868,2868,15000US060979901000,0,12,0,12,0,12,0,12,0,12,0,12,0,12,21869
2869,2869,15000US060990001011,527,77,35,25,8,12,27,22,492,77,122,41,370,80,21870
2870,2870,15000US060990001012,367,54,7,7,2,3,5,6,360,54,91,40,269,55,21871
2871,2871,15000US060990001013,471,66,13,10,0,12,13,10,458,67,122,52,336,66,21872
2872,2872,15000US060990001014,397,88,18,19,10,14,8,12,379,88,137,67,242,64,21873
2873,2873,15000US060990001021,194,62,0,12,0,12,0,12,194,62,64,47,130,58,21874
2874,2874,15000US060990001022,764,111,5,9,0,12,5,9,759,111,168,61,591,92,21875
2875,2875,15000US060990001023,426,92,99,85,33,44,66,63,327,87,108,65,219,79,21876
2876,2876,15000US060990002011,685,104,38,58,0,12,38,58,647,106,131,68,516,115,21877
2877,2877,15000US060990002012,548,89,20,32,20,32,0,12,528,99,64,57,464,106,21878
2878,2878,15000US060990002013,324,73,47,45,11,19,36,41,277,83,95,65,182,82,21879
2879,2879,15000US060990002014,265,78,162,70,103,70,59,70,103,64,19,32,84,64,21880
2880,2880,15000US060990002015,421,119,10,16,10,16,0,12,411,120,63,60,348,109,21881
2881,2881,15000US060990002021,565,182,151,141,132,135,19,31,414,133,63,63,351,125,21882
2882,2882,15000US060990002022,1491,191,68,75,68,75,0,17,1423,199,225,77,1198,184,21883
2883,2883,15000US060990002023,332,139,75,93,13,19,62,91,257,126,41,39,216,119,21884
2884,2884,15000US060990002031,855,156,129,104,26,28,103,101,726,146,236,115,490,125,21885
2885,2885,15000US060990002032,329,123,100,76,41,50,59,49,229,101,60,59,169,83,21886
2886,2886,15000US060990002033,431,118,102,78,35,55,67,66,329,113,57,71,272,100,21887
2887,2887,15000US060990002034,1132,195,114,111,0,12,114,111,1018,179,301,122,717,165,21888
2888,2888,15000US060990002035,695,122,8,14,8,14,0,12,687,123,115,59,572,134,21889
2889,2889,15000US060990003011,420,56,77,37,29,26,48,30,343,55,45,26,298,55,21890
2890,2890,15000US060990003012,279,44,100,34,26,23,74,29,179,42,76,27,103,47,21891
2891,2891,15000US060990003021,240,49,63,41,18,19,45,37,177,47,32,25,145,49,21892
2892,2892,15000US060990003022,263,51,42,25,0,12,42,25,221,53,68,46,153,37,21893
2893,2893,15000US060990003023,311,52,36,28,3,6,33,29,275,42,26,19,249,45,21894
2894,2894,15000US060990003031,706,120,79,48,70,49,9,14,627,125,110,49,517,132,21895
2895,2895,15000US060990003032,428,74,55,37,35,31,20,23,373,71,84,50,289,78,21896
2896,2896,15000US060990003033,668,108,25,28,11,16,14,22,643,111,211,75,432,101,21897
2897,2897,15000US060990003041,263,66,49,35,0,12,49,35,214,70,42,30,172,69,21898
2898,2898,15000US060990003042,518,76,35,29,17,21,18,19,483,80,137,61,346,84,21899
2899,2899,15000US060990003043,683,103,88,55,29,36,59,41,595,115,133,72,462,101,21900
2900,2900,15000US060990004021,488,130,38,39,21,25,17,27,450,130,62,50,388,137,21901
2901,2901,15000US060990004022,269,127,0,12,0,12,0,12,269,127,174,133,95,49,21902
2902,2902,15000US060990004023,2225,154,115,61,29,34,86,57,2110,150,322,134,1788,179,21903
2903,2903,15000US060990004024,187,44,0,12,0,12,0,12,187,44,73,46,114,51,21904
2904,2904,15000US060990004025,212,94,0,12,0,12,0,12,212,94,49,33,163,96,21905
2905,2905,15000US060990004031,1057,91,59,37,32,31,27,22,998,99,275,70,723,102,21906
2906,2906,15000US060990004032,460,84,22,24,22,24,0,12,438,93,173,66,265,86,21907
2907,2907,15000US060990004041,603,167,155,127,28,31,127,123,448,147,266,141,182,96,21908
2908,2908,15000US060990004042,952,124,138,111,39,58,99,98,814,121,195,98,619,124,21909
2909,2909,15000US060990004043,523,116,15,24,15,24,0,12,508,118,93,57,415,121,21910
2910,2910,15000US060990005011,497,109,0,12,0,12,0,12,497,109,171,99,326,101,21911
2911,2911,15000US060990005012,585,143,79,91,47,79,32,41,506,148,76,64,430,151,21912
2912,2912,15000US060990005013,652,167,0,12,0,12,0,12,652,167,204,131,448,152,21913
2913,2913,15000US060990005014,680,177,39,48,24,41,15,27,641,180,125,84,516,178,21914
2914,2914,15000US060990005031,685,100,145,63,59,36,86,53,540,98,89,66,451,95,21915
2915,2915,15000US060990005032,613,78,18,19,0,12,18,19,595,80,154,63,441,91,21916
2916,2916,15000US060990005033,505,97,127,62,17,18,110,61,378,80,105,49,273,73,21917
2917,2917,15000US060990005041,1856,178,75,51,14,24,61,45,1781,187,301,149,1480,209,21918
2918,2918,15000US060990005042,624,122,0,12,0,12,0,12,624,122,214,98,410,126,21919
2919,2919,15000US060990005043,529,115,0,12,0,12,0,12,529,115,238,115,291,106,21920
2920,2920,15000US060990005051,1021,111,176,71,60,40,116,62,845,113,268,73,577,114,21921
2921,2921,15000US060990005052,597,101,21,20,0,12,21,20,576,99,79,39,497,103,21922
2922,2922,15000US060990005061,495,98,132,85,55,51,77,64,363,88,136,65,227,78,21923
2923,2923,15000US060990005062,611,115,45,36,21,25,24,25,566,115,84,49,482,129,21924
2924,2924,15000US060990005063,367,84,47,30,5,9,42,31,320,85,67,44,253,89,21925
2925,2925,15000US060990005064,302,50,0,12,0,12,0,12,302,50,107,45,195,54,21926
2926,2926,15000US060990005101,661,167,40,60,40,60,0,12,621,160,80,52,541,155,21927
2927,2927,15000US060990005102,863,157,87,74,42,47,45,60,776,180,364,167,412,169,21928
2928,2928,15000US060990005103,605,115,38,43,22,36,16,25,567,120,158,79,409,124,21929
2929,2929,15000US060990005104,406,167,176,124,100,101,76,80,230,124,45,54,185,111,21930
2930,2930,15000US060990006011,302,74,34,41,0,12,34,41,268,71,37,34,231,72,21931
2931,2931,15000US060990006012,599,92,31,29,13,20,18,21,568,89,100,51,468,101,21932
2932,2932,15000US060990006013,525,102,62,42,0,12,62,42,463,101,143,69,320,99,21933
2933,2933,15000US060990006021,345,48,30,20,24,17,6,9,315,50,89,40,226,50,21934
2934,2934,15000US060990006022,533,59,64,40,22,27,42,32,469,73,162,52,307,81,21935
2935,2935,15000US060990008011,533,108,72,71,54,67,18,30,461,98,133,74,328,108,21936
2936,2936,15000US060990008012,732,118,58,46,40,36,18,28,674,121,353,126,321,104,21937
2937,2937,15000US060990008013,284,83,49,70,49,70,0,12,235,66,61,44,174,62,21938
2938,2938,15000US060990008014,557,129,35,27,0,12,35,27,522,133,107,60,415,136,21939
2939,2939,15000US060990008015,461,91,8,14,0,12,8,14,453,92,138,74,315,86,21940
2940,2940,15000US060990008031,241,74,72,48,53,46,19,22,169,63,37,26,132,64,21941
2941,2941,15000US060990008032,509,114,268,111,107,74,161,89,241,76,71,49,170,69,21942
2942,2942,15000US060990008033,761,104,205,71,36,28,169,63,556,101,242,74,314,91,21943
2943,2943,15000US060990008051,682,139,156,101,74,56,82,91,526,115,219,106,307,105,21944
2944,2944,15000US060990008052,495,96,108,66,50,37,58,52,387,91,198,68,189,88,21945
2945,2945,15000US060990008053,293,84,44,50,13,15,31,46,249,80,89,59,160,61,21946
2946,2946,15000US060990008054,613,113,80,50,48,48,32,30,533,118,188,84,345,122,21947
2947,2947,15000US060990008061,811,114,83,63,30,31,53,55,728,122,231,86,497,122,21948
2948,2948,15000US060990008062,779,108,145,61,62,44,83,41,634,114,318,98,316,116,21949
2949,2949,15000US060990008071,538,86,0,12,0,12,0,12,538,86,157,70,381,100,21950
2950,2950,15000US060990008072,1029,97,204,87,100,72,104,63,825,114,169,70,656,117,21951
2951,2951,15000US060990009051,755,163,67,55,16,27,51,46,688,168,203,130,485,159,21952
2952,2952,15000US060990009052,722,122,45,41,45,41,0,12,677,132,303,119,374,103,21953
2953,2953,15000US060990009053,592,109,4,20,4,20,0,12,588,112,109,80,479,119,21954
2954,2954,15000US060990009061,624,122,113,77,80,67,33,34,511,132,194,106,317,117,21955
2955,2955,15000US060990009062,1050,172,41,45,19,30,22,34,1009,174,243,111,766,172,21956
2956,2956,15000US060990009063,583,92,59,59,0,12,59,59,524,89,131,63,393,94,21957
2957,2957,15000US060990009071,442,82,0,12,0,12,0,12,442,82,120,71,322,70,21958
2958,2958,15000US060990009072,444,77,9,14,9,14,0,12,435,77,134,47,301,76,21959
2959,2959,15000US060990009073,412,82,0,12,0,12,0,12,412,82,152,62,260,84,21960
2960,2960,15000US060990009081,448,85,10,15,0,12,10,15,438,83,93,35,345,78,21961
2961,2961,15000US060990009082,781,119,125,63,80,57,45,41,656,123,103,48,553,119,21962
2962,2962,15000US060990009083,704,100,125,56,44,44,81,58,579,91,136,53,443,81,21963
2963,2963,15000US060990009091,820,89,153,67,99,58,54,43,667,94,208,65,459,118,21964
2964,2964,15000US060990009092,551,111,124,65,27,25,97,59,427,95,95,38,332,89,21965
2965,2965,15000US060990009093,357,84,20,30,20,30,0,12,337,82,158,59,179,70,21966
2966,2966,15000US060990009101,619,135,147,82,53,43,94,83,472,131,227,119,245,105,21967
2967,2967,15000US060990009102,771,158,225,119,40,50,185,110,546,182,200,114,346,136,21968
2968,2968,15000US060990009103,201,94,0,12,0,12,0,12,201,94,102,83,99,64,21969
2969,2969,15000US060990009104,511,117,99,61,14,23,85,54,412,116,124,65,288,133,21970
2970,2970,15000US060990009111,502,81,6,10,0,12,6,10,496,81,106,65,390,89,21971
2971,2971,15000US060990009112,769,111,83,49,11,16,72,49,686,119,197,75,489,105,21972
2972,2972,15000US060990009113,526,90,81,60,59,54,22,27,445,99,89,52,356,99,21973
2973,2973,15000US060990009121,188,71,0,12,0,12,0,12,188,71,46,43,142,73,21974
2974,2974,15000US060990009122,344,126,0,12,0,12,0,12,344,126,19,32,325,131,21975
2975,2975,15000US060990009123,5254,194,152,113,122,101,30,48,5102,208,930,284,4172,359,21976
2976,2976,15000US060990010011,447,121,86,80,0,12,86,80,361,106,143,98,218,76,21977
2977,2977,15000US060990010012,684,124,53,54,53,54,0,12,631,131,150,90,481,128,21978
2978,2978,15000US060990010013,464,106,93,90,81,89,12,22,371,105,152,82,219,108,21979
2979,2979,15000US060990010014,334,65,25,32,12,20,13,23,309,69,88,50,221,68,21980
2980,2980,15000US060990010015,492,123,145,108,99,93,46,45,347,94,138,62,209,93,21981
2981,2981,15000US060990010021,343,72,44,52,5,8,39,52,299,74,77,54,222,59,21982
2982,2982,15000US060990010022,592,92,62,43,28,33,34,28,530,95,235,88,295,95,21983
2983,2983,15000US060990010023,424,77,64,59,5,9,59,59,360,76,183,65,177,68,21984
2984,2984,15000US060990011001,384,61,49,42,17,19,32,38,335,56,120,41,215,62,21985
2985,2985,15000US060990011002,417,96,212,88,68,60,144,89,205,83,46,31,159,78,21986
2986,2986,15000US060990011003,452,101,86,68,60,57,26,37,366,101,212,90,154,50,21987
2987,2987,15000US060990011004,291,81,47,36,19,22,28,28,244,78,105,46,139,74,21988
2988,2988,15000US060990012001,210,62,29,34,20,33,9,14,181,58,49,34,132,51,21989
2989,2989,15000US060990012002,545,92,119,60,18,21,101,56,426,96,121,69,305,86,21990
2990,2990,15000US060990012003,754,96,223,75,79,47,144,66,531,90,53,35,478,90,21991
2991,2991,15000US060990013001,378,99,127,93,57,76,70,60,251,83,139,81,112,56,21992
2992,2992,15000US060990013002,389,109,111,102,65,80,46,72,278,90,81,81,197,85,21993
2993,2993,15000US060990013003,525,104,26,41,26,41,0,12,499,110,135,107,364,106,21994
2994,2994,15000US060990013004,554,95,30,41,0,12,30,41,524,88,162,81,362,120,21995
2995,2995,15000US060990013005,377,83,30,43,0,12,30,43,347,89,59,40,288,100,21996
2996,2996,15000US060990013006,314,95,0,12,0,12,0,12,314,95,145,77,169,85,21997
2997,2997,15000US060990014001,679,167,182,132,113,110,69,75,497,151,103,91,394,130,21998
2998,2998,15000US060990014002,407,134,180,78,142,85,38,47,227,133,94,106,133,73,21999
2999,2999,15000US060990014003,344,138,200,139,34,50,166,133,144,104,18,29,126,102,22000
3000,3000,15000US060990014004,694,145,82,80,68,76,14,23,612,144,234,128,378,128,22001
3001,3001,15000US060990014005,199,95,83,70,37,56,46,46,116,79,45,64,71,48,22002
3002,3002,15000US060990015001,653,136,195,93,131,67,64,65,458,146,110,83,348,127,22003
3003,3003,15000US060990015002,448,125,76,56,60,51,16,26,372,132,134,75,238,125,22004
3004,3004,15000US060990015003,669,145,193,109,123,87,70,67,476,148,101,70,375,140,22005
3005,3005,15000US060990015004,290,64,56,47,23,33,33,35,234,67,71,39,163,63,22006
3006,3006,15000US060990016011,308,82,106,54,34,30,72,51,202,73,73,48,129,64,22007
3007,3007,15000US060990016012,534,82,160,67,49,44,111,59,374,86,121,65,253,79,22008
3008,3008,15000US060990016013,425,92,189,83,0,12,189,83,236,75,70,50,166,71,22009
3009,3009,15000US060990016031,350,88,220,84,146,71,74,54,130,61,70,46,60,43,22010
3010,3010,15000US060990016032,400,96,140,81,84,72,56,52,260,74,93,51,167,62,22011
3011,3011,15000US060990016033,239,77,61,41,29,23,32,37,178,74,59,40,119,65,22012
3012,3012,15000US060990016034,506,104,197,95,56,51,141,89,309,97,78,57,231,86,22013
3013,3013,15000US060990016041,339,62,145,54,100,49,45,31,194,64,36,25,158,60,22014
3014,3014,15000US060990016042,466,68,253,71,73,47,180,57,213,60,116,48,97,46,22015
3015,3015,15000US060990016043,246,55,88,46,43,28,45,36,158,56,44,23,114,52,22016
3016,3016,15000US060990017001,522,66,207,68,85,42,122,60,315,71,101,49,214,64,22017
3017,3017,15000US060990017002,226,61,74,39,59,38,15,10,152,58,49,33,103,48,22018
3018,3018,15000US060990018001,295,61,22,22,5,9,17,21,273,61,82,39,191,52,22019
3019,3019,15000US060990018002,591,74,163,45,62,31,101,40,428,69,227,59,201,48,22020
3020,3020,15000US060990018003,0,12,0,12,0,12,0,12,0,12,0,12,0,12,22021
3021,3021,15000US060990019001,826,133,75,73,75,73,0,12,751,137,275,152,476,111,22022
3022,3022,15000US060990019002,198,75,35,39,0,12,35,39,163,64,42,38,121,63,22023
3023,3023,15000US060990019003,445,111,35,40,16,25,19,31,410,107,94,57,316,119,22024
3024,3024,15000US060990019004,287,109,0,12,0,12,0,12,287,109,51,38,236,108,22025
3025,3025,15000US060990019005,293,100,81,73,16,26,65,80,212,83,62,60,150,65,22026
3026,3026,15000US060990020021,684,102,119,64,17,17,102,61,565,95,135,58,430,95,22027
3027,3027,15000US060990020022,429,97,76,62,18,28,58,55,353,100,126,71,227,87,22028
3028,3028,15000US060990020023,281,95,108,67,41,44,67,62,173,80,68,57,105,63,22029
3029,3029,15000US060990020041,484,83,136,76,45,39,91,68,348,90,92,40,256,95,22030
3030,3030,15000US060990020042,244,59,64,56,15,17,49,52,180,53,96,40,84,43,22031
3031,3031,15000US060990020043,668,117,220,73,98,48,122,63,448,105,210,83,238,97,22032
3032,3032,15000US060990020044,623,123,212,92,122,66,90,56,411,120,205,98,206,97,22033
3033,3033,15000US060990020051,723,85,241,87,112,88,129,72,482,95,146,69,336,94,22034
3034,3034,15000US060990020052,432,84,27,27,18,21,9,14,405,86,130,57,275,91,22035
3035,3035,15000US060990020061,676,107,47,54,27,43,20,33,629,108,153,77,476,118,22036
3036,3036,15000US060990020062,627,109,81,45,40,32,41,36,546,108,146,77,400,120,22037
3037,3037,15000US060990021001,549,91,227,75,121,67,106,66,322,88,173,67,149,72,22038
3038,3038,15000US060990021002,519,92,131,73,51,45,80,56,388,104,126,65,262,95,22039
3039,3039,15000US060990022001,534,82,125,66,35,26,90,66,409,81,124,56,285,84,22040
3040,3040,15000US060990022002,747,93,332,80,136,61,196,75,415,82,151,67,264,85,22041
3041,3041,15000US060990022003,147,52,59,40,22,28,37,28,88,45,19,21,69,42,22042
3042,3042,15000US060990022004,401,89,164,82,74,61,90,55,237,70,78,55,159,64,22043
3043,3043,15000US060990023011,484,122,91,62,45,45,46,42,393,108,98,60,295,93,22044
3044,3044,15000US060990023012,842,119,218,88,58,49,160,81,624,141,94,70,530,142,22045
3045,3045,15000US060990023013,273,94,178,82,103,80,75,53,95,69,46,43,49,56,22046
3046,3046,15000US060990023014,474,108,93,61,57,47,36,40,381,103,162,71,219,96,22047
3047,3047,15000US060990023021,655,99,134,71,71,55,63,50,521,106,160,70,361,103,22048
3048,3048,15000US060990023022,463,99,132,62,73,44,59,47,331,96,81,66,250,90,22049
3049,3049,15000US060990024011,393,70,78,39,29,19,49,37,315,76,88,52,227,70,22050
3050,3050,15000US060990024012,540,73,133,56,32,31,101,53,407,77,88,46,319,75,22051
3051,3051,15000US060990024021,695,110,334,103,100,63,234,83,361,107,151,88,210,96,22052
3052,3052,15000US060990024022,34,27,19,30,0,12,19,30,15,24,0,12,15,24,22053
3053,3053,15000US060990024023,690,120,254,107,56,45,198,99,436,118,178,82,258,107,22054
3054,3054,15000US060990025011,406,83,132,56,22,20,110,57,274,79,105,62,169,71,22055
3055,3055,15000US060990025012,0,12,0,12,0,12,0,12,0,12,0,12,0,12,22056
3056,3056,15000US060990025013,1203,94,136,78,39,38,97,65,1067,110,309,101,758,124,22057
3057,3057,15000US060990025031,385,87,86,58,62,53,24,24,299,85,78,46,221,79,22058
3058,3058,15000US060990025032,342,113,95,73,10,16,85,71,247,101,53,39,194,100,22059
3059,3059,15000US060990025033,475,116,143,82,32,41,111,81,332,107,132,75,200,90,22060
3060,3060,15000US060990025041,536,94,87,50,45,34,42,38,449,97,125,56,324,84,22061
3061,3061,15000US060990025042,678,82,114,59,45,32,69,58,564,94,198,79,366,106,22062
3062,3062,15000US060990026021,331,75,74,44,40,41,34,22,257,78,136,59,121,65,22063
3063,3063,15000US060990026022,716,116,263,87,165,74,98,67,453,110,181,81,272,97,22064
3064,3064,15000US060990026023,524,114,94,54,73,49,21,22,430,105,88,56,342,111,22065
3065,3065,15000US060990026031,211,56,24,21,9,14,15,17,187,57,67,30,120,50,22066
3066,3066,15000US060990026032,644,57,49,31,40,29,9,10,595,64,179,56,416,65,22067
3067,3067,15000US060990026041,386,85,91,66,18,19,73,65,295,94,97,44,198,89,22068
3068,3068,15000US060990026042,326,76,110,58,53,39,57,48,216,78,83,43,133,72,22069
3069,3069,15000US060990026043,586,126,226,98,52,40,174,88,360,116,125,71,235,93,22070
3070,3070,15000US060990026051,568,82,68,54,17,19,51,49,500,82,180,80,320,80,22071
3071,3071,15000US060990026052,703,100,246,106,131,100,115,81,457,101,175,73,282,93,22072
3072,3072,15000US060990027011,524,91,106,73,51,46,55,58,418,104,111,59,307,95,22073
3073,3073,15000US060990027012,619,84,123,58,60,42,63,49,496,97,157,68,339,97,22074
3074,3074,15000US060990027021,538,99,161,80,18,19,143,75,377,106,50,52,327,96,22075
3075,3075,15000US060990027022,504,99,209,83,88,51,121,76,295,98,106,56,189,84,22076
3076,3076,15000US060990027023,365,82,59,38,8,13,51,35,306,83,74,54,232,74,22077
3077,3077,15000US060990027024,299,70,51,41,12,14,39,37,248,64,71,43,177,57,22078
3078,3078,15000US060990027025,308,84,39,39,6,9,33,37,269,73,139,53,130,60,22079
3079,3079,15000US060990028011,777,105,88,46,56,38,32,29,689,113,148,72,541,111,22080
3080,3080,15000US060990028012,533,104,37,24,14,17,23,23,496,104,200,83,296,86,22081
3081,3081,15000US060990028013,322,68,0,12,0,12,0,12,322,68,53,35,269,80,22082
3082,3082,15000US060990028021,306,80,21,27,0,12,21,27,285,75,118,81,167,68,22083
3083,3083,15000US060990028022,815,99,267,108,148,90,119,77,548,132,141,76,407,122,22084
3084,3084,15000US060990028023,358,80,0,12,0,12,0,12,358,80,208,72,150,67,22085
3085,3085,15000US060990028024,417,113,61,58,35,44,26,42,356,103,77,53,279,106,22086
3086,3086,15000US060990028031,691,85,75,49,30,30,45,45,616,102,181,97,435,112,22087
3087,3087,15000US060990028032,489,84,20,21,6,9,14,19,469,86,172,67,297,87,22088
3088,3088,15000US060990029011,339,45,40,20,29,16,11,10,299,43,110,33,189,37,22089
3089,3089,15000US060990029012,281,46,4,5,2,3,2,3,277,46,100,44,177,41,22090
3090,3090,15000US060990029013,277,52,24,14,10,11,14,10,253,48,41,17,212,50,22091
3091,3091,15000US060990029014,217,42,39,37,8,11,31,36,178,46,65,25,113,45,22092
3092,3092,15000US060990029015,481,75,52,39,52,39,0,12,429,76,139,53,290,74,22093
3093,3093,15000US060990029021,688,135,9,16,0,12,9,16,679,135,188,109,491,111,22094
3094,3094,15000US060990029022,1267,198,100,76,63,68,37,33,1167,194,422,152,745,182,22095
3095,3095,15000US060990029023,373,110,181,112,58,60,123,99,192,89,139,87,53,43,22096
3096,3096,15000US060990029024,274,86,19,30,19,30,0,12,255,86,69,58,186,81,22097
3097,3097,15000US060990030011,1879,154,53,46,33,34,20,31,1826,157,454,149,1372,188,22098
3098,3098,15000US060990030012,279,85,9,19,9,19,0,12,270,88,115,74,155,85,22099
3099,3099,15000US060990030013,314,95,89,63,17,26,72,62,225,76,81,59,144,61,22100
3100,3100,15000US060990030021,368,120,73,81,28,41,45,70,295,89,190,83,105,50,22101
3101,3101,15000US060990030022,402,92,72,52,47,45,25,38,330,91,158,60,172,77,22102
3102,3102,15000US060990030023,879,131,427,135,221,99,206,94,452,118,167,77,285,106,22103
3103,3103,15000US060990030024,387,93,77,42,52,42,25,26,310,90,71,50,239,79,22104
3104,3104,15000US060990031001,255,70,33,34,24,33,9,15,222,73,69,52,153,66,22105
3105,3105,15000US060990031002,297,86,131,86,14,17,117,83,166,73,101,72,65,42,22106
3106,3106,15000US060990031003,677,117,150,85,9,13,141,87,527,115,163,67,364,108,22107
3107,3107,15000US060990032011,370,71,60,49,0,12,60,49,310,83,148,64,162,66,22108
3108,3108,15000US060990032012,459,81,192,78,43,27,149,71,267,76,54,39,213,71,22109
3109,3109,15000US060990032013,319,69,50,38,17,28,33,30,269,69,133,64,136,49,22110
3110,3110,15000US060990032014,200,48,35,25,11,19,24,17,165,52,22,20,143,51,22111
3111,3111,15000US060990032021,419,157,86,84,31,40,55,89,333,141,63,80,270,125,22112
3112,3112,15000US060990032022,1421,279,215,151,60,95,155,123,1206,280,86,70,1120,284,22113
3113,3113,15000US060990032023,2326,293,343,153,165,127,178,119,1983,331,231,131,1752,332,22114
3114,3114,15000US060990032024,349,145,176,118,20,33,156,116,173,118,12,22,161,116,22115
3115,3115,15000US060990033001,379,96,53,35,29,27,24,22,326,96,102,58,224,82,22116
3116,3116,15000US060990033002,594,99,75,60,21,32,54,50,519,103,95,50,424,104,22117
3117,3117,15000US060990033003,232,46,28,32,8,13,20,31,204,48,64,33,140,50,22118
3118,3118,15000US060990033004,342,69,88,55,23,26,65,48,254,71,45,40,209,65,22119
3119,3119,15000US060990034001,304,57,43,34,12,18,31,29,261,56,96,45,165,57,22120
3120,3120,15000US060990034002,250,64,35,22,14,20,21,15,215,62,62,37,153,56,22121
3121,3121,15000US060990035001,1572,193,328,141,120,81,208,132,1244,206,354,125,890,188,22122
3122,3122,15000US060990035002,315,84,12,20,0,12,12,20,303,91,125,86,178,92,22123
3123,3123,15000US060990035003,620,163,94,97,47,56,47,70,526,163,136,82,390,158,22124
3124,3124,15000US060990035004,854,193,134,100,101,90,33,42,720,175,322,133,398,165,22125
3125,3125,15000US060990036031,196,64,14,20,0,12,14,20,182,65,14,15,168,66,22126
3126,3126,15000US060990036032,199,77,0,12,0,12,0,12,199,77,18,25,181,75,22127
3127,3127,15000US060990036033,329,83,53,47,26,36,27,30,276,79,81,43,195,83,22128
3128,3128,15000US060990036034,491,94,37,45,21,35,16,26,454,98,95,53,359,106,22129
3129,3129,15000US060990036041,286,73,0,12,0,12,0,12,286,73,108,57,178,83,22130
3130,3130,15000US060990036042,203,81,112,74,0,12,112,74,91,47,18,21,73,42,22131
3131,3131,15000US060990036043,857,140,93,67,43,52,50,44,764,147,152,76,612,147,22132
3132,3132,15000US060990036044,350,105,48,56,14,23,34,52,302,99,11,17,291,104,22133
3133,3133,15000US060990036045,1085,130,26,34,21,33,5,9,1059,135,159,64,900,152,22134
3134,3134,15000US060990036051,1219,152,81,59,17,27,64,61,1138,155,348,106,790,157,22135
3135,3135,15000US060990036052,1587,184,121,97,0,12,121,97,1466,208,471,175,995,171,22136
3136,3136,15000US060990036053,0,12,0,12,0,12,0,12,0,12,0,12,0,12,22137
3137,3137,15000US060990036061,2518,202,44,41,0,17,44,41,2474,202,674,176,1800,209,22138
3138,3138,15000US060990036062,1063,176,35,32,0,12,35,32,1028,178,241,104,787,174,22139
3139,3139,15000US060990037001,764,92,156,84,49,48,107,67,608,87,203,67,405,110,22140
3140,3140,15000US060990037002,232,64,20,18,9,14,11,13,212,63,69,48,143,51,22141
3141,3141,15000US060990037003,345,65,38,42,21,29,17,30,307,61,121,47,186,65,22142
3142,3142,15000US060990038021,266,67,80,49,21,25,59,46,186,70,98,57,88,45,22143
3143,3143,15000US060990038022,317,79,115,57,35,36,80,46,202,63,101,61,101,55,22144
3144,3144,15000US060990038023,556,110,145,75,64,53,81,53,411,100,73,55,338,99,22145
3145,3145,15000US060990038024,470,97,191,82,94,58,97,65,279,89,107,67,172,72,22146
3146,3146,15000US060990038031,426,70,89,46,33,29,56,35,337,65,108,41,229,67,22147
3147,3147,15000US060990038032,400,65,114,50,72,43,42,35,286,58,128,48,158,58,22148
3148,3148,15000US060990038041,419,120,68,60,38,44,30,38,351,106,102,70,249,103,22149
3149,3149,15000US060990038042,401,137,58,52,26,30,32,41,343,138,88,46,255,136,22150
3150,3150,15000US060990038043,1029,159,30,34,15,24,15,23,999,163,352,140,647,163,22151
3151,3151,15000US060990038044,479,170,183,125,0,12,183,125,296,126,66,63,230,118,22152
3152,3152,15000US060990038051,924,69,54,32,13,14,41,25,870,77,233,60,637,79,22153
3153,3153,15000US060990039041,483,85,29,26,18,20,11,17,454,85,119,50,335,83,22154
3154,3154,15000US060990039042,292,69,76,62,64,61,12,19,216,60,63,39,153,54,22155
3155,3155,15000US060990039043,554,93,40,35,10,17,30,31,514,99,271,75,243,96,22156
3156,3156,15000US060990039044,461,97,83,77,33,52,50,60,378,101,195,81,183,96,22157
3157,3157,15000US060990039051,346,58,0,12,0,12,0,12,346,58,118,68,228,55,22158
3158,3158,15000US060990039052,469,62,21,23,21,23,0,12,448,66,72,41,376,72,22159
3159,3159,15000US060990039053,502,66,23,26,0,12,23,26,479,68,86,45,393,76,22160
3160,3160,15000US060990039054,203,47,20,19,12,16,8,13,183,47,39,30,144,49,22161
3161,3161,15000US060990039061,385,92,100,81,79,76,21,24,285,80,97,55,188,66,22162
3162,3162,15000US060990039062,965,125,320,111,83,44,237,104,645,120,203,96,442,102,22163
3163,3163,15000US060990039063,603,115,115,60,24,31,91,53,488,117,180,95,308,84,22164
3164,3164,15000US060990039071,698,119,31,33,18,27,13,20,667,124,174,107,493,122,22165
3165,3165,15000US060990039072,882,164,26,34,0,12,26,34,856,164,319,143,537,148,22166
3166,3166,15000US060990039073,431,115,40,40,0,12,40,40,391,112,196,90,195,76,22167
3167,3167,15000US060990039074,882,138,26,28,13,19,13,20,856,136,191,94,665,161,22168
3168,3168,15000US060990039081,516,77,132,51,18,17,114,50,384,73,184,53,200,68,22169
3169,3169,15000US060990039082,384,74,107,50,10,13,97,52,277,74,51,33,226,68,22170
3170,3170,15000US060990039091,621,164,155,121,89,119,66,51,466,137,106,64,360,137,22171
3171,3171,15000US060990039092,566,131,78,71,46,55,32,45,488,130,263,122,225,102,22172
3172,3172,15000US060990039093,566,130,76,68,15,25,61,68,490,123,74,59,416,120,22173
3173,3173,15000US060990039094,450,161,82,58,29,33,53,49,368,165,158,117,210,143,22174
3174,3174,15000US060990040001,342,75,10,12,3,5,7,11,332,73,109,49,223,65,22175
3175,3175,15000US060990040002,364,73,0,12,0,12,0,12,364,73,59,31,305,74,22176
3176,3176,15000US060990040003,528,70,34,19,19,15,15,12,494,68,148,49,346,58,22177
3177,3177,15000US061010501011,903,129,54,42,8,14,46,38,849,129,312,94,537,127,22178
3178,3178,15000US061010501012,613,136,65,56,0,12,65,56,548,136,74,73,474,134,22179
3179,3179,15000US061010501013,487,138,200,91,0,12,200,91,287,126,64,56,223,115,22180
3180,3180,15000US061010501014,395,107,46,30,9,15,37,35,349,107,242,105,107,69,22181
3181,3181,15000US061010501021,582,111,38,31,18,21,20,23,544,108,230,82,314,102,22182
3182,3182,15000US061010501022,577,93,140,89,16,18,124,87,437,95,123,57,314,88,22183
3183,3183,15000US061010501023,643,110,163,80,96,63,67,54,480,98,207,65,273,81,22184
3184,3184,15000US061010502011,625,88,108,59,33,38,75,55,517,91,136,65,381,90,22185
3185,3185,15000US061010502012,539,83,75,47,32,33,43,36,464,92,37,27,427,94,22186
3186,3186,15000US061010502021,282,89,108,73,20,21,88,71,174,64,63,36,111,62,22187
3187,3187,15000US061010502022,333,72,66,48,22,25,44,41,267,66,84,39,183,67,22188
3188,3188,15000US061010502023,246,90,52,48,14,23,38,40,194,84,138,76,56,45,22189
3189,3189,15000US061010502024,533,88,191,87,23,23,168,82,342,96,114,50,228,88,22190
3190,3190,15000US061010503011,392,64,26,22,5,7,21,22,366,66,89,31,277,72,22191
3191,3191,15000US061010503012,587,72,49,41,36,39,13,13,538,70,127,41,411,75,22192
3192,3192,15000US061010503021,435,110,22,26,22,26,0,12,413,113,100,50,313,112,22193
3193,3193,15000US061010503022,651,133,153,95,19,18,134,90,498,132,99,84,399,123,22194
3194,3194,15000US061010503023,319,108,125,76,88,67,37,37,194,88,43,38,151,85,22195
3195,3195,15000US061010503024,470,101,39,50,6,10,33,50,431,97,122,62,309,98,22196
3196,3196,15000US061010504011,409,95,48,40,7,12,41,40,361,90,137,83,224,80,22197
3197,3197,15000US061010504012,403,87,11,16,0,12,11,16,392,87,60,39,332,84,22198
3198,3198,15000US061010504013,441,90,70,62,70,62,0,12,371,90,113,57,258,83,22199
3199,3199,15000US061010504014,387,92,21,28,21,28,0,12,366,92,128,66,238,104,22200
3200,3200,15000US061010504021,455,71,13,16,0,12,13,16,442,72,126,49,316,78,22201
3201,3201,15000US061010504022,861,92,69,56,12,14,57,55,792,102,245,78,547,84,22202
3202,3202,15000US061010504031,985,83,112,52,77,47,35,31,873,93,225,89,648,96,22203
3203,3203,15000US061010505011,342,62,19,17,17,16,2,6,323,66,113,39,210,65,22204
3204,3204,15000US061010505012,195,47,0,12,0,12,0,12,195,47,45,31,150,44,22205
3205,3205,15000US061010505013,703,105,75,54,10,14,65,52,628,107,86,56,542,114,22206
3206,3206,15000US061010505014,706,119,200,102,91,78,109,70,506,109,135,53,371,98,22207
3207,3207,15000US061010505031,224,68,38,37,20,33,18,21,186,63,79,46,107,47,22208
3208,3208,15000US061010505032,486,139,24,28,13,22,11,18,462,144,190,124,272,129,22209
3209,3209,15000US061010505033,599,150,28,35,16,25,12,24,571,149,173,102,398,145,22210
3210,3210,15000US061010505034,250,88,0,12,0,12,0,12,250,88,25,27,225,86,22211
3211,3211,15000US061010505035,526,113,63,63,18,29,45,53,463,112,198,99,265,97,22212
3212,3212,15000US061010505041,465,96,3,6,0,12,3,6,462,96,125,69,337,88,22213
3213,3213,15000US061010505042,248,106,26,39,0,12,26,39,222,101,80,74,142,90,22214
3214,3214,15000US061010505043,1120,157,37,48,0,12,37,48,1083,156,260,116,823,184,22215
3215,3215,15000US061010505044,346,89,0,12,0,12,0,12,346,89,100,74,246,73,22216
3216,3216,15000US061010506011,401,90,1,3,1,3,0,12,400,89,95,56,305,87,22217
3217,3217,15000US061010506012,557,111,54,61,9,14,45,60,503,98,116,55,387,101,22218
3218,3218,15000US061010506013,990,150,110,73,8,14,102,71,880,137,299,108,581,117,22219
3219,3219,15000US061010506031,339,63,17,19,9,14,8,13,322,63,185,61,137,53,22220
3220,3220,15000US061010506032,431,69,49,48,19,24,30,42,382,72,49,35,333,72,22221
3221,3221,15000US061010506033,537,91,9,16,0,12,9,16,528,91,104,54,424,97,22222
3222,3222,15000US061010506034,610,77,13,19,0,12,13,19,597,79,228,79,369,90,22223
3223,3223,15000US061010506041,558,100,39,27,27,21,12,18,519,101,116,56,403,98,22224
3224,3224,15000US061010506042,1032,120,26,28,12,20,14,17,1006,125,231,84,775,129,22225
3225,3225,15000US061010507011,781,98,158,70,87,70,71,43,623,108,224,69,399,113,22226
3226,3226,15000US061010507012,583,92,132,61,73,46,59,37,451,82,144,62,307,78,22227
3227,3227,15000US061010507021,826,111,180,85,46,30,134,72,646,110,245,79,401,87,22228
3228,3228,15000US061010507022,577,91,90,42,41,27,49,32,487,96,171,58,316,94,22229
3229,3229,15000US061010507023,317,57,15,14,15,14,0,12,302,57,144,60,158,51,22230
3230,3230,15000US061010508001,776,113,40,35,30,31,10,17,736,112,197,87,539,102,22231
3231,3231,15000US061010508002,483,88,7,11,0,12,7,11,476,89,141,72,335,101,22232
3232,3232,15000US061010509001,293,41,40,26,11,16,29,21,253,44,71,25,182,39,22233
3233,3233,15000US061010509002,326,56,52,37,21,19,31,33,274,60,90,48,184,54,22234
3234,3234,15000US061010510001,305,67,27,19,13,13,14,14,278,65,32,17,246,69,22235
3235,3235,15000US061010510002,540,88,69,54,49,51,20,22,471,88,107,50,364,93,22236
3236,3236,15000US061010511001,256,35,17,15,10,11,7,10,239,33,74,26,165,28,22237
3237,3237,15000US061010511002,320,49,15,9,11,8,4,4,305,48,91,29,214,39,22238
3238,3238,15000US061010511003,427,58,25,18,21,18,4,5,402,59,113,35,289,48,22239
3239,3239,15000US061030001001,407,79,52,38,29,32,23,22,355,71,97,31,258,59,22240
3240,3240,15000US061030001002,678,83,77,44,40,24,37,37,601,83,250,58,351,65,22241
3241,3241,15000US061030001003,359,67,28,24,23,22,5,8,331,65,97,38,234,59,22242
3242,3242,15000US061030001004,295,66,9,12,9,12,0,12,286,66,99,39,187,62,22243
3243,3243,15000US061030002001,608,154,89,81,64,73,25,40,519,159,225,127,294,117,22244
3244,3244,15000US061030002002,1235,179,73,75,44,59,29,42,1162,169,347,116,815,188,22245
3245,3245,15000US061030002003,1192,143,52,45,31,34,21,27,1140,150,411,161,729,156,22246
3246,3246,15000US061030003001,773,101,48,40,17,19,31,40,725,104,313,83,412,79,22247
3247,3247,15000US061030003002,988,122,189,80,134,63,55,44,799,119,382,116,417,125,22248
3248,3248,15000US061030004001,712,94,14,12,13,12,1,3,698,95,223,88,475,107,22249
3249,3249,15000US061030004002,590,99,55,38,50,35,5,11,535,104,227,96,308,72,22250
3250,3250,15000US061030004003,849,128,90,69,29,33,61,58,759,136,252,126,507,148,22251
3251,3251,15000US061030005001,839,161,70,63,39,42,31,47,769,145,213,105,556,154,22252
3252,3252,15000US061030005002,239,109,22,34,22,34,0,12,217,111,12,18,205,112,22253
3253,3253,15000US061030005003,364,102,114,74,44,41,70,61,250,93,65,54,185,87,22254
3254,3254,15000US061030005004,483,116,75,57,35,32,40,46,408,128,273,129,135,64,22255
3255,3255,15000US061030005005,270,103,45,43,12,18,33,39,225,111,93,69,132,87,22256
3256,3256,15000US061030006001,837,177,268,180,102,112,166,164,569,146,242,114,327,117,22257
3257,3257,15000US061030006002,578,125,87,103,87,103,0,12,491,106,223,90,268,106,22258
3258,3258,15000US061030006003,503,110,216,125,53,62,163,109,287,91,76,52,211,84,22259
3259,3259,15000US061030007001,576,140,247,128,77,48,170,125,329,105,85,57,244,98,22260
3260,3260,15000US061030007002,731,193,59,49,22,25,37,43,672,196,377,167,295,139,22261
3261,3261,15000US061030007003,327,113,0,12,0,12,0,12,327,113,189,105,138,82,22262
3262,3262,15000US061030007004,682,176,203,136,69,72,134,127,479,141,216,89,263,119,22263
3263,3263,15000US061030007005,591,149,89,66,33,31,56,54,502,128,221,101,281,116,22264
3264,3264,15000US061030008001,328,85,44,49,26,44,18,21,284,81,113,56,171,71,22265
3265,3265,15000US061030008002,195,73,24,24,7,11,17,22,171,70,48,37,123,65,22266
3266,3266,15000US061030008003,373,106,73,85,65,84,8,13,300,89,71,60,229,73,22267
3267,3267,15000US061030008004,474,113,65,50,0,12,65,50,409,112,200,96,209,85,22268
3268,3268,15000US061030009001,352,81,56,49,5,7,51,49,296,72,99,34,197,72,22269
3269,3269,15000US061030009002,558,87,85,53,69,51,16,16,473,90,189,76,284,80,22270
3270,3270,15000US061030009003,474,94,27,26,6,10,21,24,447,92,155,73,292,81,22271
3271,3271,15000US061030010001,219,44,15,11,10,10,5,6,204,44,61,26,143,39,22272
3272,3272,15000US061030010002,1073,154,133,115,130,115,3,7,940,187,319,125,621,171,22273
3273,3273,15000US061030010003,442,146,105,73,49,59,56,66,337,147,76,82,261,130,22274
3274,3274,15000US061030010004,413,91,15,23,0,12,15,23,398,95,155,73,243,84,22275
3275,3275,15000US061030010005,245,51,16,11,3,4,13,11,229,50,75,34,154,43,22276
3276,3276,15000US061030011001,351,103,14,19,11,18,3,4,337,105,51,40,286,105,22277
3277,3277,15000US061030011002,399,115,251,138,92,92,159,111,148,103,35,33,113,100,22278
3278,3278,15000US061030011003,361,161,6,9,1,2,5,8,355,161,101,104,254,124,22279
3279,3279,15000US061030011004,796,171,156,108,46,69,110,84,640,166,203,104,437,150,22280
3280,3280,15000US061030011005,199,77,19,32,19,32,0,12,180,70,13,20,167,73,22281
3281,3281,15000US061030011006,615,156,116,107,56,73,60,80,499,141,66,45,433,145,22282
3282,3282,15000US061050001011,189,52,11,12,6,9,5,9,178,48,89,40,89,34,22283
3283,3283,15000US061050001012,594,91,69,43,45,34,24,23,525,85,273,72,252,61,22284
3284,3284,15000US061050001013,278,65,15,18,13,18,2,3,263,62,82,39,181,57,22285
3285,3285,15000US061050001021,465,133,34,37,28,36,6,11,431,134,120,57,311,115,22286
3286,3286,15000US061050001022,794,152,148,98,27,40,121,87,646,138,325,131,321,127,22287
3287,3287,15000US061050001023,537,144,0,12,0,12,0,12,537,144,166,110,371,137,22288
3288,3288,15000US061050002001,471,69,46,21,14,11,32,21,425,65,169,41,256,55,22289
3289,3289,15000US061050002002,411,80,29,22,21,18,8,12,382,78,144,53,238,69,22290
3290,3290,15000US061050003001,488,169,130,104,29,44,101,93,358,117,169,95,189,87,22291
3291,3291,15000US061050003002,594,134,30,47,0,12,30,47,564,141,317,129,247,103,22292
3292,3292,15000US061050003003,303,101,27,42,27,42,0,12,276,92,166,72,110,70,22293
3293,3293,15000US061050004001,223,58,0,12,0,12,0,12,223,58,119,45,104,45,22294
3294,3294,15000US061050004002,121,31,0,12,0,12,0,12,121,31,47,22,74,26,22295
3295,3295,15000US061070001001,67,32,3,4,3,4,0,12,64,32,12,12,52,31,22296
3296,3296,15000US061070001002,203,66,8,9,3,5,5,8,195,66,110,67,85,45,22297
3297,3297,15000US061070001003,484,101,26,35,0,12,26,35,458,99,185,86,273,65,22298
3298,3298,15000US061070001004,477,78,19,15,8,9,11,10,458,71,103,37,355,65,22299
3299,3299,15000US061070001005,592,109,52,34,20,24,32,27,540,106,192,68,348,85,22300
3300,3300,15000US061070002011,487,150,256,157,103,109,153,150,231,99,98,69,133,72,22301
3301,3301,15000US061070002012,444,131,78,66,49,54,29,33,366,113,61,46,305,113,22302
3302,3302,15000US061070002013,309,131,105,79,14,24,91,75,204,110,26,43,178,104,22303
3303,3303,15000US061070002014,438,133,155,73,63,49,92,74,283,134,120,103,163,95,22304
3304,3304,15000US061070002015,528,167,173,127,85,94,88,84,355,176,99,103,256,131,22305
3305,3305,15000US061070002021,210,61,96,43,25,20,71,45,114,62,43,33,71,51,22306
3306,3306,15000US061070002022,239,60,30,27,16,15,14,22,209,56,55,40,154,48,22307
3307,3307,15000US061070002023,210,64,79,44,26,23,53,36,131,52,39,31,92,46,22308
3308,3308,15000US061070003011,575,115,105,95,44,67,61,68,470,110,126,91,344,94,22309
3309,3309,15000US061070003012,434,101,135,59,34,31,101,53,299,90,69,39,230,74,22310
3310,3310,15000US061070003013,388,89,40,37,8,10,32,36,348,92,129,52,219,77,22311
3311,3311,15000US061070003014,138,39,47,25,27,20,20,18,91,35,39,28,52,32,22312
3312,3312,15000US061070003015,148,84,38,44,13,20,25,40,110,78,49,76,61,47,22313
3313,3313,15000US061070003016,300,105,50,41,31,32,19,24,250,112,114,84,136,102,22314
3314,3314,15000US061070003021,153,30,41,21,12,10,29,20,112,25,34,19,78,21,22315
3315,3315,15000US061070003022,491,42,238,49,88,37,150,42,253,49,85,27,168,46,22316
3316,3316,15000US061070003023,217,34,77,26,26,14,51,21,140,28,45,22,95,27,22317
3317,3317,15000US061070004011,305,82,65,46,8,14,57,43,240,80,39,34,201,79,22318
3318,3318,15000US061070004012,620,104,158,58,71,47,87,57,462,99,141,65,321,94,22319
3319,3319,15000US061070004013,714,100,230,92,27,32,203,88,484,98,145,66,339,95,22320
3320,3320,15000US061070004021,284,84,56,72,0,12,56,72,228,61,36,27,192,63,22321
3321,3321,15000US061070004022,1207,176,340,141,84,68,256,129,867,165,382,118,485,157,22322
3322,3322,15000US061070004023,619,155,299,152,82,95,217,135,320,120,96,88,224,123,22323
3323,3323,15000US061070005011,607,93,197,76,57,42,140,65,410,92,162,60,248,80,22324
3324,3324,15000US061070005012,314,74,118,50,13,20,105,46,196,64,86,39,110,59,22325
3325,3325,15000US061070005013,416,85,175,60,31,29,144,59,241,79,86,54,155,63,22326
3326,3326,15000US061070005014,397,69,131,58,30,23,101,54,266,73,85,42,181,68,22327
3327,3327,15000US061070005021,934,76,217,80,52,40,165,74,717,106,186,70,531,98,22328
3328,3328,15000US061070006001,508,106,133,78,37,50,96,60,375,95,91,52,284,100,22329
3329,3329,15000US061070006002,358,107,213,88,64,59,149,77,145,80,64,54,81,64,22330
3330,3330,15000US061070006003,201,93,130,81,22,36,108,73,71,47,27,21,44,47,22331
3331,3331,15000US061070006004,479,108,125,85,12,11,113,84,354,90,118,48,236,80,22332
3332,3332,15000US061070007011,392,54,96,57,19,16,77,55,296,65,33,20,263,64,22333
3333,3333,15000US061070007012,387,70,41,32,18,17,23,28,346,72,94,51,252,64,22334
3334,3334,15000US061070007021,527,92,187,80,27,36,160,66,340,102,69,47,271,97,22335
3335,3335,15000US061070007022,267,69,21,20,15,18,6,9,246,66,94,52,152,59,22336
3336,3336,15000US061070007023,559,105,85,45,4,8,81,43,474,101,112,51,362,98,22337
3337,3337,15000US061070007024,247,91,77,60,18,22,59,55,170,76,73,51,97,64,22338
3338,3338,15000US061070008001,210,66,106,60,59,57,47,27,104,42,44,28,60,33,22339
3339,3339,15000US061070008002,421,152,50,52,50,52,0,12,371,149,0,12,371,149,22340
3340,3340,15000US061070008003,396,131,13,21,13,21,0,12,383,135,35,31,348,130,22341
3341,3341,15000US061070008004,206,109,15,24,0,12,15,24,191,111,134,101,57,45,22342
3342,3342,15000US061070008005,410,102,228,98,54,47,174,99,182,107,59,68,123,82,22343
3343,3343,15000US061070008006,598,145,154,98,49,45,105,85,444,141,127,81,317,129,22344
3344,3344,15000US061070009001,163,54,31,22,0,12,31,22,132,52,70,44,62,42,22345
3345,3345,15000US061070009002,625,118,107,78,34,53,73,58,518,116,117,62,401,110,22346
3346,3346,15000US061070009003,235,88,51,49,15,17,36,45,184,81,39,34,145,75,22347
3347,3347,15000US061070009004,719,115,315,98,84,61,231,86,404,95,66,45,338,100,22348
3348,3348,15000US061070009005,241,82,73,52,30,34,43,43,168,81,106,68,62,60,22349
3349,3349,15000US061070010031,2472,414,0,17,0,17,0,17,2472,414,226,161,2246,416,22350
3350,3350,15000US061070010032,865,280,58,97,58,97,0,12,807,273,22,44,785,273,22351
3351,3351,15000US061070010033,1354,365,178,152,178,152,0,12,1176,374,427,267,749,314,22352
3352,3352,15000US061070010034,1401,424,397,370,204,233,193,284,1004,249,363,189,641,243,22353
3353,3353,15000US061070010035,466,198,161,141,88,108,73,95,305,188,31,51,274,179,22354
3354,3354,15000US061070010041,564,100,181,89,26,23,155,87,383,100,88,52,295,90,22355
3355,3355,15000US061070010042,488,112,126,66,55,34,71,53,362,98,184,86,178,67,22356
3356,3356,15000US061070010043,660,129,276,110,139,88,137,77,384,103,178,64,206,89,22357
3357,3357,15000US061070010044,274,87,130,71,38,36,92,65,144,65,43,36,101,59,22358
3358,3358,15000US061070010051,1036,83,114,71,102,69,12,20,922,108,223,88,699,106,22359
3359,3359,15000US061070010061,279,63,0,12,0,12,0,12,279,63,73,54,206,75,22360
3360,3360,15000US061070010062,440,125,46,51,19,29,27,43,394,133,54,50,340,123,22361
3361,3361,15000US061070010063,828,154,88,102,21,33,67,96,740,167,109,62,631,159,22362
3362,3362,15000US061070010064,393,89,14,23,0,12,14,23,379,93,71,52,308,96,22363
3363,3363,15000US061070010065,278,87,0,12,0,12,0,12,278,87,110,96,168,75,22364
3364,3364,15000US061070011001,483,108,276,89,71,58,205,81,207,90,105,65,102,73,22365
3365,3365,15000US061070011002,274,101,120,57,58,41,62,46,154,93,72,66,82,62,22366
3366,3366,15000US061070011003,719,120,373,102,198,82,175,76,346,97,136,56,210,82,22367
3367,3367,15000US061070011004,484,109,207,89,25,24,182,83,277,93,159,81,118,65,22368
3368,3368,15000US061070012001,521,60,134,52,91,40,43,27,387,66,152,47,235,61,22369
3369,3369,15000US061070013011,822,161,81,86,0,12,81,86,741,159,243,145,498,159,22370
3370,3370,15000US061070013012,883,198,183,129,58,52,125,124,700,179,142,94,558,170,22371
3371,3371,15000US061070013013,921,148,265,119,129,109,136,100,656,162,158,109,498,134,22372
3372,3372,15000US061070013021,130,92,12,20,0,12,12,20,118,89,101,84,17,28,22373
3373,3373,15000US061070013022,652,159,123,71,67,70,56,52,529,170,194,116,335,147,22374
3374,3374,15000US061070013023,791,183,173,123,0,12,173,123,618,172,175,103,443,157,22375
3375,3375,15000US061070013024,872,159,175,99,91,68,84,80,697,176,91,76,606,171,22376
3376,3376,15000US061070014001,810,90,160,76,24,27,136,69,650,101,133,65,517,119,22377
3377,3377,15000US061070014002,274,64,0,12,0,12,0,12,274,64,94,46,180,59,22378
3378,3378,15000US061070014003,257,50,9,13,0,12,9,13,248,48,66,33,182,49,22379
3379,3379,15000US061070014004,270,90,30,43,0,12,30,43,240,79,107,62,133,62,22380
3380,3380,15000US061070014005,242,48,42,26,16,18,26,20,200,47,53,24,147,38,22381
3381,3381,15000US061070015011,866,129,133,64,10,16,123,64,733,136,214,92,519,125,22382
3382,3382,15000US061070015012,1011,124,171,76,77,50,94,60,840,129,226,66,614,125,22383
3383,3383,15000US061070015021,626,103,98,59,24,28,74,61,528,99,142,45,386,96,22384
3384,3384,15000US061070015022,274,79,88,64,11,17,77,62,186,73,6,9,180,75,22385
3385,3385,15000US061070015023,617,115,227,86,64,54,163,63,390,110,66,39,324,104,22386
3386,3386,15000US061070015024,264,80,66,42,19,21,47,41,198,76,98,52,100,62,22387
3387,3387,15000US061070016011,317,76,83,55,34,27,49,48,234,68,99,51,135,64,22388
3388,3388,15000US061070016012,320,99,152,78,89,61,63,49,168,80,70,50,98,69,22389
3389,3389,15000US061070016013,311,89,135,70,20,22,115,65,176,81,62,49,114,68,22390
3390,3390,15000US061070016014,350,77,139,63,62,41,77,49,211,75,105,46,106,65,22391
3391,3391,15000US061070016021,211,93,123,82,58,45,65,69,88,64,55,52,33,40,22392
3392,3392,15000US061070016022,478,92,77,52,26,22,51,47,401,87,94,48,307,96,22393
3393,3393,15000US061070016023,544,99,106,66,43,37,63,55,438,108,174,71,264,98,22394
3394,3394,15000US061070016024,273,61,71,54,21,20,50,50,202,55,63,28,139,48,22395
3395,3395,15000US061070017011,445,109,215,113,114,80,101,93,230,110,91,71,139,105,22396
3396,3396,15000US061070017012,358,128,129,89,0,12,129,89,229,106,97,77,132,103,22397
3397,3397,15000US061070017013,527,119,195,107,125,85,70,77,332,132,167,107,165,92,22398
3398,3398,15000US061070017014,451,104,159,90,90,69,69,58,292,112,12,24,280,113,22399
3399,3399,15000US061070017015,423,111,57,44,0,12,57,44,366,115,170,84,196,89,22400
3400,3400,15000US061070017031,707,173,87,100,13,20,74,98,620,189,119,85,501,184,22401
3401,3401,15000US061070017032,651,169,16,28,0,12,16,28,635,165,275,155,360,119,22402
3402,3402,15000US061070017033,1177,175,58,54,16,24,42,49,1119,175,227,84,892,178,22403
3403,3403,15000US061070017041,2446,178,455,196,152,114,303,172,1991,242,467,171,1524,223,22404
3404,3404,15000US061070018001,280,80,35,44,8,12,27,43,245,71,77,55,168,58,22405
3405,3405,15000US061070018002,667,98,121,68,72,63,49,33,546,82,163,58,383,85,22406
3406,3406,15000US061070018003,330,70,10,15,0,12,10,15,320,70,133,66,187,72,22407
3407,3407,15000US061070018004,468,97,135,64,63,44,72,54,333,82,111,54,222,84,22408
3408,3408,15000US061070019011,320,96,13,16,7,11,6,11,307,96,79,37,228,89,22409
3409,3409,15000US061070019012,634,117,49,46,19,23,30,39,585,109,252,93,333,126,22410
3410,3410,15000US061070019013,269,85,15,25,0,12,15,25,254,84,40,28,214,88,22411
3411,3411,15000US061070019021,257,81,47,36,20,26,27,25,210,84,40,32,170,80,22412
3412,3412,15000US061070019022,392,87,88,61,17,27,71,54,304,86,48,44,256,83,22413
3413,3413,15000US061070019023,461,70,54,48,12,18,42,43,407,68,98,52,309,67,22414
3414,3414,15000US061070019024,298,77,27,26,12,19,15,19,271,73,72,37,199,73,22415
3415,3415,15000US061070020021,264,60,37,35,16,18,21,32,227,60,78,47,149,54,22416
3416,3416,15000US061070020022,541,107,209,75,141,68,68,58,332,91,107,45,225,92,22417
3417,3417,15000US061070020023,377,79,44,28,38,26,6,11,333,80,86,48,247,72,22418
3418,3418,15000US061070020024,397,75,34,22,25,21,9,14,363,76,100,45,263,74,22419
3419,3419,15000US061070020031,444,141,141,100,43,54,98,85,303,106,77,54,226,104,22420
3420,3420,15000US061070020032,278,92,56,55,14,25,42,50,222,86,93,63,129,81,22421
3421,3421,15000US061070020033,175,80,11,19,11,19,0,12,164,82,29,42,135,75,22422
3422,3422,15000US061070020034,625,157,115,69,45,45,70,65,510,163,38,46,472,165,22423
3423,3423,15000US061070020035,566,167,194,115,102,84,92,82,372,135,128,88,244,111,22424
3424,3424,15000US061070020041,365,90,48,41,48,41,0,12,317,88,130,74,187,64,22425
3425,3425,15000US061070020042,946,118,95,62,14,17,81,59,851,121,312,89,539,112,22426
3426,3426,15000US061070020043,418,79,42,42,34,40,8,14,376,78,75,42,301,72,22427
3427,3427,15000US061070020061,477,77,18,20,0,12,18,20,459,78,178,60,281,73,22428
3428,3428,15000US061070020062,1056,90,105,66,8,12,97,64,951,94,147,76,804,97,22429
3429,3429,15000US061070020071,1303,152,60,50,36,38,24,31,1243,157,365,116,878,159,22430
3430,3430,15000US061070020072,1104,161,76,55,60,49,16,23,1028,157,322,132,706,170,22431
3431,3431,15000US061070020073,561,146,212,139,21,34,191,132,349,131,125,101,224,117,22432
3432,3432,15000US061070020081,792,94,282,81,106,64,176,84,510,110,198,91,312,95,22433
3433,3433,15000US061070020082,328,80,21,21,7,11,14,18,307,81,150,68,157,68,22434
3434,3434,15000US061070020091,506,101,52,35,28,25,24,22,454,100,133,65,321,96,22435
3435,3435,15000US061070020092,714,97,115,71,55,59,60,42,599,119,134,66,465,108,22436
3436,3436,15000US061070020093,302,81,50,41,6,10,44,41,252,81,66,40,186,75,22437
3437,3437,15000US061070021001,305,39,69,24,16,12,53,20,236,42,65,28,171,39,22438
3438,3438,15000US061070021002,380,41,82,29,32,19,50,23,298,44,89,31,209,44,22439
3439,3439,15000US061070022021,555,91,302,91,122,69,180,73,253,83,93,48,160,78,22440
3440,3440,15000US061070022022,202,67,48,26,25,22,23,25,154,69,25,24,129,66,22441
3441,3441,15000US061070022023,921,102,331,92,164,76,167,71,590,116,154,59,436,118,22442
3442,3442,15000US061070022031,810,101,282,100,117,70,165,84,528,104,147,71,381,107,22443
3443,3443,15000US061070022032,360,84,46,39,7,11,39,38,314,78,52,36,262,82,22444
3444,3444,15000US061070022041,1057,128,407,112,78,62,329,99,650,103,207,76,443,103,22445
3445,3445,15000US061070022042,473,109,125,75,60,47,65,63,348,92,188,81,160,76,22446
3446,3446,15000US061070022043,243,80,70,43,61,41,9,15,173,83,40,29,133,85,22447
3447,3447,15000US061070023021,437,88,32,29,10,15,22,25,405,92,238,102,167,55,22448
3448,3448,15000US061070023022,762,113,86,51,27,26,59,42,676,101,237,73,439,88,22449
3449,3449,15000US061070023023,386,78,93,46,25,31,68,46,293,80,95,55,198,73,22450
3450,3450,15000US061070023031,326,99,16,24,16,24,0,12,310,99,93,78,217,95,22451
3451,3451,15000US061070023032,833,165,13,18,0,12,13,18,820,164,155,70,665,172,22452
3452,3452,15000US061070023033,421,130,0,12,0,12,0,12,421,130,140,71,281,125,22453
3453,3453,15000US061070023034,569,124,72,68,13,24,59,61,497,122,224,107,273,120,22454
3454,3454,15000US061070023035,273,87,23,36,23,36,0,12,250,79,34,53,216,73,22455
3455,3455,15000US061070023041,380,63,119,52,53,36,66,43,261,62,138,61,123,42,22456
3456,3456,15000US061070023042,345,56,63,39,6,9,57,39,282,60,89,42,193,61,22457
3457,3457,15000US061070024001,1597,171,98,48,31,30,67,37,1499,171,375,117,1124,185,22458
3458,3458,15000US061070024002,322,100,63,70,46,66,17,26,259,74,45,37,214,75,22459
3459,3459,15000US061070024003,501,132,39,44,24,41,15,16,462,135,148,83,314,127,22460
3460,3460,15000US061070024004,425,105,46,34,14,13,32,32,379,104,99,46,280,104,22461
3461,3461,15000US061070024005,840,127,8,12,8,12,0,12,832,127,276,92,556,131,22462
3462,3462,15000US061070025001,170,67,8,13,8,13,0,12,162,65,51,29,111,66,22463
3463,3463,15000US061070025002,335,83,30,39,0,12,30,39,305,77,126,47,179,69,22464
3464,3464,15000US061070025003,287,73,72,57,58,57,14,16,215,82,28,26,187,84,22465
3465,3465,15000US061070025004,362,79,106,52,6,9,100,51,256,82,60,53,196,81,22466
3466,3466,15000US061070026011,414,120,160,89,52,50,108,80,254,107,102,65,152,93,22467
3467,3467,15000US061070026012,223,102,67,53,12,20,55,60,156,102,8,14,148,101,22468
3468,3468,15000US061070026013,648,124,98,64,22,24,76,58,550,133,104,56,446,130,22469
3469,3469,15000US061070026021,258,81,50,33,24,23,26,26,208,81,73,50,135,66,22470
3470,3470,15000US061070026022,417,92,85,67,30,27,55,63,332,84,150,76,182,96,22471
3471,3471,15000US061070026023,316,87,21,23,10,15,11,17,295,92,66,42,229,90,22472
3472,3472,15000US061070026024,360,95,145,70,34,56,111,73,215,98,46,43,169,95,22473
3473,3473,15000US061070026025,184,72,74,69,33,52,41,45,110,69,21,25,89,69,22474
3474,3474,15000US061070027001,221,94,0,12,0,12,0,12,221,94,38,36,183,106,22475
3475,3475,15000US061070027002,525,124,44,68,0,12,44,68,481,122,118,58,363,128,22476
3476,3476,15000US061070027003,311,110,105,88,88,83,17,24,206,112,161,105,45,40,22477
3477,3477,15000US061070027004,1058,142,74,35,15,12,59,30,984,142,347,116,637,129,22478
3478,3478,15000US061070027005,292,83,33,25,1,3,32,24,259,80,134,83,125,42,22479
3479,3479,15000US061070028001,581,107,300,87,57,37,243,78,281,64,103,37,178,60,22480
3480,3480,15000US061070028002,420,82,133,58,33,34,100,48,287,73,57,35,230,67,22481
3481,3481,15000US061070029011,627,86,156,69,62,41,94,55,471,93,164,57,307,97,22482
3482,3482,15000US061070029012,384,68,100,51,11,18,89,45,284,69,117,52,167,65,22483
3483,3483,15000US061070029013,114,52,56,45,56,45,0,12,58,55,32,39,26,40,22484
3484,3484,15000US061070029031,687,98,106,76,43,64,63,50,581,95,114,49,467,96,22485
3485,3485,15000US061070029032,381,105,77,58,40,49,37,32,304,108,79,46,225,100,22486
3486,3486,15000US061070029033,259,95,45,45,11,16,34,42,214,88,97,47,117,82,22487
3487,3487,15000US061070029034,295,68,74,63,74,63,0,12,221,52,67,40,154,47,22488
3488,3488,15000US061070029041,978,106,217,87,130,69,87,57,761,113,257,82,504,107,22489
3489,3489,15000US061070029042,608,103,144,69,50,36,94,62,464,91,164,76,300,81,22490
3490,3490,15000US061070030011,328,93,129,68,91,61,38,29,199,75,107,61,92,49,22491
3491,3491,15000US061070030012,483,111,299,104,123,68,176,85,184,82,28,25,156,79,22492
3492,3492,15000US061070030013,429,93,213,97,28,34,185,97,216,74,97,53,119,52,22493
3493,3493,15000US061070030021,430,88,80,51,14,16,66,50,350,86,123,51,227,78,22494
3494,3494,15000US061070030022,507,77,151,71,51,43,100,57,356,86,122,57,234,69,22495
3495,3495,15000US061070031001,213,45,12,10,2,3,10,9,201,43,35,16,166,41,22496
3496,3496,15000US061070031002,571,62,212,55,72,36,140,47,359,54,116,34,243,52,22497
3497,3497,15000US061070031003,227,42,50,28,7,11,43,27,177,40,46,22,131,38,22498
3498,3498,15000US061070032001,706,78,342,86,89,42,253,75,364,75,106,51,258,69,22499
3499,3499,15000US061070032002,131,43,25,26,8,13,17,24,106,36,14,15,92,35,22500
3500,3500,15000US061070032003,188,48,21,19,0,12,21,19,167,46,53,33,114,39,22501
3501,3501,15000US061070032004,423,60,139,49,28,21,111,47,284,63,116,46,168,53,22502
3502,3502,15000US061070032005,261,51,131,42,36,28,95,40,130,38,7,9,123,38,22503
3503,3503,15000US061070033001,435,140,29,32,29,32,0,12,406,142,44,30,362,136,22504
3504,3504,15000US061070033002,335,68,120,44,36,25,84,42,215,52,56,30,159,50,22505
3505,3505,15000US061070033003,179,40,12,17,1,4,11,16,167,39,31,19,136,40,22506
3506,3506,15000US061070033004,256,110,129,80,30,33,99,82,127,110,0,12,127,110,22507
3507,3507,15000US061070033005,385,104,58,39,30,31,28,23,327,101,110,48,217,102,22508
3508,3508,15000US061070033006,551,161,225,152,96,100,129,112,326,140,60,40,266,133,22509
3509,3509,15000US061070034001,709,109,265,81,41,31,224,78,444,97,94,48,350,86,22510
3510,3510,15000US061070034002,291,59,73,34,39,26,34,23,218,50,72,27,146,44,22511
3511,3511,15000US061070034003,250,86,38,34,15,20,23,28,212,81,49,25,163,72,22512
3512,3512,15000US061070034004,605,158,57,30,12,14,45,31,548,156,133,79,415,151,22513
3513,3513,15000US061070034005,176,54,32,31,0,12,32,31,144,49,50,26,94,46,22514
3514,3514,15000US061070035011,944,59,129,59,18,15,111,59,815,75,258,63,557,80,22515
3515,3515,15000US061070035021,263,114,0,12,0,12,0,12,263,114,109,92,154,91,22516
3516,3516,15000US061070035022,614,149,166,94,33,54,133,104,448,141,172,83,276,120,22517
3517,3517,15000US061070035023,587,177,158,125,23,35,135,123,429,162,100,80,329,151,22518
3518,3518,15000US061070035024,1621,223,69,86,17,26,52,82,1552,230,394,140,1158,218,22519
3519,3519,15000US061070036011,580,147,180,119,30,31,150,121,400,117,115,74,285,108,22520
3520,3520,15000US061070036012,460,92,147,90,43,48,104,81,313,85,96,72,217,96,22521
3521,3521,15000US061070036013,307,96,6,13,6,13,0,12,301,97,113,62,188,90,22522
3522,3522,15000US061070036014,663,134,350,144,172,114,178,120,313,134,42,43,271,132,22523
3523,3523,15000US061070036021,639,146,305,116,79,69,226,93,334,143,57,65,277,118,22524
3524,3524,15000US061070036022,407,116,91,77,49,61,42,49,316,103,121,76,195,103,22525
3525,3525,15000US061070036023,1091,160,132,86,11,18,121,85,959,147,107,80,852,144,22526
3526,3526,15000US061070037001,458,102,102,67,10,17,92,65,356,97,36,37,320,97,22527
3527,3527,15000US061070037002,360,83,93,62,20,27,73,56,267,66,93,66,174,67,22528
3528,3528,15000US061070037003,649,115,134,83,49,32,85,80,515,112,104,46,411,114,22529
3529,3529,15000US061070037004,391,104,100,57,51,34,49,52,291,97,60,39,231,86,22530
3530,3530,15000US061070038011,424,92,68,61,0,12,68,61,356,100,87,55,269,90,22531
3531,3531,15000US061070038012,582,88,214,93,28,38,186,88,368,96,139,66,229,86,22532
3532,3532,15000US061070038021,579,96,187,77,52,43,135,66,392,90,189,65,203,85,22533
3533,3533,15000US061070038022,369,93,201,89,59,52,142,76,168,82,54,54,114,69,22534
3534,3534,15000US061070038023,511,99,133,77,13,16,120,76,378,83,104,46,274,83,22535
3535,3535,15000US061070039011,231,86,26,22,17,18,9,13,205,85,26,20,179,88,22536
3536,3536,15000US061070039012,215,90,130,84,8,12,122,82,85,51,23,26,62,54,22537
3537,3537,15000US061070039013,229,82,66,46,47,49,19,20,163,67,37,27,126,70,22538
3538,3538,15000US061070039014,561,143,180,106,27,43,153,101,381,107,88,61,293,95,22539
3539,3539,15000US061070039015,581,135,196,105,67,52,129,85,385,121,167,78,218,104,22540
3540,3540,15000US061070039021,731,109,133,74,68,52,65,50,598,95,112,46,486,97,22541
3541,3541,15000US061070039022,449,70,127,44,32,16,95,39,322,65,73,44,249,71,22542
3542,3542,15000US061070039023,333,74,149,48,29,19,120,47,184,56,81,33,103,47,22543
3543,3543,15000US061070040001,0,12,0,12,0,12,0,12,0,12,0,12,0,12,22544
3544,3544,15000US061070041011,848,180,263,130,36,43,227,128,585,190,114,70,471,183,22545
3545,3545,15000US061070041012,623,155,273,121,51,44,222,119,350,170,95,63,255,162,22546
3546,3546,15000US061070041013,545,161,243,132,59,78,184,127,302,121,236,130,66,65,22547
3547,3547,15000US061070041014,546,191,177,107,75,82,102,71,369,184,103,109,266,139,22548
3548,3548,15000US061070041021,600,44,157,60,41,28,116,56,443,71,126,51,317,67,22549
3549,3549,15000US061070042001,291,76,136,69,27,36,109,64,155,66,44,40,111,59,22550
3550,3550,15000US061070042002,243,94,91,68,29,43,62,55,152,84,47,55,105,57,22551
3551,3551,15000US061070042003,799,139,337,125,138,79,199,99,462,126,204,89,258,90,22552
3552,3552,15000US061070042004,275,76,59,46,9,13,50,43,216,72,32,21,184,73,22553
3553,3553,15000US061070043001,458,53,161,33,35,19,126,32,297,47,82,28,215,43,22554
3554,3554,15000US061070043002,434,88,178,61,66,40,112,51,256,90,87,50,169,80,22555
3555,3555,15000US061070043003,222,49,33,24,9,12,24,20,189,46,56,29,133,40,22556
3556,3556,15000US061070043004,670,71,257,56,65,30,192,56,413,58,146,42,267,52,22557
3557,3557,15000US061070044001,871,110,415,115,120,64,295,103,456,115,165,80,291,95,22558
3558,3558,15000US061070044002,345,88,158,79,41,39,117,70,187,79,48,41,139,65,22559
3559,3559,15000US061070044003,199,71,84,55,0,12,84,55,115,64,0,12,115,64,22560
3560,3560,15000US061070044004,326,85,82,60,0,12,82,60,244,77,97,59,147,65,22561
3561,3561,15000US061070045001,828,100,235,70,70,45,165,57,593,111,129,53,464,104,22562
3562,3562,15000US061070045002,186,74,94,58,26,30,68,51,92,51,42,33,50,43,22563
3563,3563,15000US061070045003,293,84,108,66,39,43,69,52,185,68,85,52,100,58,22564
3564,3564,15000US061070045004,352,63,34,28,20,19,14,19,318,67,74,41,244,64,22565
3565,3565,15000US061090011001,433,81,30,33,0,12,30,33,403,85,91,50,312,86,22566
3566,3566,15000US061090011002,354,87,35,28,0,12,35,28,319,86,97,55,222,82,22567
3567,3567,15000US061090011003,628,105,43,43,22,34,21,26,585,104,152,75,433,95,22568
3568,3568,15000US061090011004,224,60,41,32,18,20,23,24,183,64,57,49,126,53,22569
3569,3569,15000US061090012001,523,132,151,99,134,100,17,20,372,113,129,61,243,106,22570
3570,3570,15000US061090012002,579,119,105,81,12,21,93,77,474,116,131,60,343,99,22571
3571,3571,15000US061090012003,618,116,160,84,57,37,103,79,458,103,186,62,272,91,22572
3572,3572,15000US061090012004,177,64,46,58,46,58,0,12,131,54,14,14,117,53,22573
3573,3573,15000US061090021001,320,74,26,20,7,8,19,18,294,70,102,50,192,49,22574
3574,3574,15000US061090021002,282,109,7,10,0,12,7,10,275,107,93,62,182,90,22575
3575,3575,15000US061090021003,337,113,33,38,0,12,33,38,304,105,75,58,229,105,22576
3576,3576,15000US061090021004,196,66,48,27,20,21,28,23,148,59,83,54,65,42,22577
3577,3577,15000US061090021005,554,121,87,60,38,28,49,54,467,120,221,80,246,110,22578
3578,3578,15000US061090021006,423,70,44,56,44,56,0,12,379,88,119,61,260,84,22579
3579,3579,15000US061090022001,372,88,68,59,36,37,32,49,304,96,51,43,253,86,22580
3580,3580,15000US061090022002,186,44,4,5,4,5,0,12,182,45,56,29,126,39,22581
3581,3581,15000US061090022003,344,102,19,23,13,20,6,10,325,97,124,85,201,79,22582
3582,3582,15000US061090022004,524,113,35,40,0,12,35,40,489,110,153,64,336,111,22583
3583,3583,15000US061090022005,802,140,7,14,0,12,7,14,795,144,294,116,501,142,22584
3584,3584,15000US061090022006,383,134,98,97,14,24,84,92,285,99,106,77,179,86,22585
3585,3585,15000US061090022007,453,105,0,12,0,12,0,12,453,105,152,104,301,90,22586
3586,3586,15000US061090031001,564,154,64,76,47,71,17,29,500,145,107,83,393,127,22587
3587,3587,15000US061090031002,580,162,46,63,37,60,9,17,534,154,197,104,337,129,22588
3588,3588,15000US061090031003,580,179,67,92,12,19,55,90,513,151,264,124,249,106,22589
3589,3589,15000US061090031004,902,255,159,106,125,102,34,51,743,232,257,147,486,190,22590
3590,3590,15000US061090031005,182,116,0,12,0,12,0,12,182,116,86,88,96,81,22591
3591,3591,15000US061090032001,657,131,31,37,20,33,11,19,626,136,147,83,479,123,22592
3592,3592,15000US061090032002,213,110,0,12,0,12,0,12,213,110,40,52,173,90,22593
3593,3593,15000US061090032003,353,106,0,12,0,12,0,12,353,106,172,86,181,83,22594
3594,3594,15000US061090032004,279,114,0,12,0,12,0,12,279,114,107,70,172,110,22595
3595,3595,15000US061090032005,523,170,130,119,130,119,0,12,393,158,167,111,226,134,22596
3596,3596,15000US061090032006,267,108,25,44,25,44,0,12,242,109,218,114,24,31,22597
3597,3597,15000US061090041001,690,156,0,12,0,12,0,12,690,156,238,110,452,140,22598
3598,3598,15000US061090041002,648,146,26,30,26,30,0,12,622,149,221,153,401,144,22599
3599,3599,15000US061090041003,712,112,63,54,47,46,16,26,649,116,217,98,432,124,22600
3600,3600,15000US061090041004,417,104,28,46,28,46,0,12,389,99,82,59,307,94,22601
3601,3601,15000US061090042001,95,42,9,14,9,14,0,12,86,40,18,20,68,34,22602
3602,3602,15000US061090042002,1216,151,60,55,31,49,29,25,1156,144,414,94,742,140,22603
3603,3603,15000US061090042003,194,76,98,71,47,53,51,45,96,52,68,53,28,23,22604
3604,3604,15000US061090051001,631,138,92,96,46,71,46,64,539,113,144,75,395,112,22605
3605,3605,15000US061090051002,544,138,67,63,48,55,19,29,477,127,216,104,261,82,22606
3606,3606,15000US061090051003,800,167,74,59,61,58,13,20,726,172,286,115,440,141,22607
3607,3607,15000US061090051004,631,140,73,71,18,27,55,65,558,130,175,67,383,126,22608
3608,3608,15000US061090051005,403,129,9,19,9,19,0,12,394,128,216,112,178,97,22609
3609,3609,15000US061090051006,542,171,119,115,119,115,0,12,423,141,167,84,256,125,22610
3610,3610,15000US061090052011,221,60,23,36,23,36,0,12,198,54,81,39,117,49,22611
3611,3611,15000US061090052012,527,57,60,32,37,28,23,20,467,54,129,43,338,56,22612
3612,3612,15000US061099852021,0,12,0,12,0,12,0,12,0,12,0,12,0,12,22613
3613,3613,15000US061110001001,301,49,26,19,3,5,23,19,275,49,75,39,200,45,22614
3614,3614,15000US061110002001,306,50,47,24,8,11,39,20,259,48,104,42,155,49,22615
3615,3615,15000US061110002002,446,48,59,33,27,26,32,25,387,51,144,54,243,56,22616
3616,3616,15000US061110003021,693,125,26,30,14,23,12,19,667,126,217,102,450,159,22617
3617,3617,15000US061110003022,868,160,65,63,0,12,65,63,803,160,287,115,516,156,22618
3618,3618,15000US061110003023,779,166,278,147,170,123,108,83,501,147,121,72,380,130,22619
3619,3619,15000US061110003031,349,82,11,17,0,12,11,17,338,82,150,58,188,66,22620
3620,3620,15000US061110003032,537,95,5,11,0,12,5,11,532,95,102,64,430,92,22621
3621,3621,15000US061110003033,496,97,53,44,31,31,22,32,443,97,86,53,357,96,22622
3622,3622,15000US061110003041,233,65,13,19,1,3,12,19,220,62,51,36,169,59,22623
3623,3623,15000US061110003042,690,111,185,96,26,29,159,90,505,129,111,55,394,125,22624
3624,3624,15000US061110003043,250,84,33,36,12,20,21,29,217,72,57,58,160,60,22625
3625,3625,15000US061110004001,189,70,26,20,11,14,15,15,163,67,42,37,121,67,22626
3626,3626,15000US061110004002,299,68,1,3,1,3,0,12,298,69,87,34,211,65,22627
3627,3627,15000US061110004003,775,115,86,48,50,33,36,33,689,118,191,69,498,117,22628
3628,3628,15000US061110004004,520,119,75,75,44,65,31,44,445,114,76,44,369,118,22629
3629,3629,15000US061110005001,572,65,53,34,7,11,46,34,519,65,187,47,332,60,22630
3630,3630,15000US061110006001,306,85,50,30,35,28,15,16,256,85,71,46,185,68,22631
3631,3631,15000US061110006002,464,88,156,62,78,57,78,39,308,91,137,68,171,71,22632
3632,3632,15000US061110006003,742,95,273,76,39,38,234,73,469,95,109,51,360,103,22633
3633,3633,15000US061110006004,421,103,140,75,53,47,87,59,281,87,50,40,231,87,22634
3634,3634,15000US061110007011,700,114,105,68,67,54,38,31,595,121,157,82,438,102,22635
3635,3635,15000US061110007012,723,102,90,57,41,47,49,37,633,102,135,64,498,110,22636
3636,3636,15000US061110007013,440,98,149,80,92,67,57,45,291,80,74,52,217,74,22637
3637,3637,15000US061110007021,494,64,24,25,20,24,4,7,470,65,143,48,327,68,22638
3638,3638,15000US061110007022,431,65,43,32,0,12,43,32,388,64,131,41,257,58,22639
3639,3639,15000US061110008001,267,114,67,82,0,12,67,82,200,85,59,72,141,50,22640
3640,3640,15000US061110008002,1271,136,131,92,74,58,57,70,1140,152,423,133,717,176,22641
3641,3641,15000US061110008003,675,107,48,32,27,26,21,18,627,104,178,69,449,89,22642
3642,3642,15000US061110008004,376,64,17,20,0,12,17,20,359,67,50,32,309,75,22643
3643,3643,15000US061110009011,782,93,0,12,0,12,0,12,782,93,194,60,588,85,22644
3644,3644,15000US061110009012,280,60,0,12,0,12,0,12,280,60,73,40,207,61,22645
3645,3645,15000US061110009021,233,56,0,12,0,12,0,12,233,56,40,29,193,53,22646
3646,3646,15000US061110009022,572,79,14,13,4,6,10,12,558,79,176,52,382,69,22647
3647,3647,15000US061110009031,955,150,82,75,22,39,60,62,873,146,174,81,699,143,22648
3648,3648,15000US061110009032,302,93,0,12,0,12,0,12,302,93,69,48,233,92,22649
3649,3649,15000US061110009033,236,75,26,33,14,23,12,22,210,94,89,83,121,59,22650
3650,3650,15000US061110009034,492,86,8,15,8,15,0,12,484,92,125,84,359,82,22651
3651,3651,15000US061110010011,220,57,7,12,0,12,7,12,213,57,45,34,168,60,22652
3652,3652,15000US061110010012,585,77,29,28,0,12,29,28,556,77,122,58,434,91,22653
3653,3653,15000US061110010013,222,64,37,41,15,22,22,33,185,61,53,30,132,67,22654
3654,3654,15000US061110010021,692,118,70,88,0,12,70,88,622,116,141,67,481,128,22655
3655,3655,15000US061110010022,399,88,24,29,16,25,8,15,375,88,158,64,217,81,22656
3656,3656,15000US061110010023,951,188,39,60,39,60,0,12,912,187,262,129,650,195,22657
3657,3657,15000US061110010024,431,99,89,73,73,81,16,28,342,91,43,40,299,95,22658
3658,3658,15000US061110011011,1214,104,48,39,25,23,23,34,1166,106,275,96,891,112,22659
3659,3659,15000US061110011012,544,77,85,51,18,20,67,46,459,88,89,43,370,93,22660
3660,3660,15000US061110011021,728,90,69,64,28,33,41,52,659,85,203,68,456,92,22661
3661,3661,15000US061110011022,643,96,56,53,5,9,51,56,587,84,224,86,363,91,22662
3662,3662,15000US061110012011,1068,82,109,60,46,32,63,53,959,93,296,83,663,96,22663
3663,3663,15000US061110012012,722,77,123,59,42,28,81,55,599,86,194,75,405,74,22664
3664,3664,15000US061110012021,638,125,0,12,0,12,0,12,638,125,99,68,539,138,22665
3665,3665,15000US061110012022,822,115,56,47,11,19,45,42,766,115,150,76,616,120,22666
3666,3666,15000US061110012023,942,116,0,12,0,12,0,12,942,116,206,97,736,131,22667
3667,3667,15000US061110012041,813,52,110,46,71,41,39,19,703,69,188,61,515,81,22668
3668,3668,15000US061110012061,341,57,7,10,0,12,7,10,334,56,74,40,260,57,22669
3669,3669,15000US061110013011,494,126,0,12,0,12,0,12,494,126,106,99,388,123,22670
3670,3670,15000US061110013012,470,152,115,132,15,23,100,128,355,127,96,57,259,125,22671
3671,3671,15000US061110013013,998,161,5,13,5,13,0,12,993,163,233,93,760,171,22672
3672,3672,15000US061110013014,741,154,51,56,21,34,30,47,690,157,121,85,569,159,22673
3673,3673,15000US061110013021,775,38,115,56,56,40,59,42,660,57,263,59,397,62,22674
3674,3674,15000US061110014011,574,64,9,14,0,12,9,14,565,64,90,47,475,70,22675
3675,3675,15000US061110014012,824,82,24,20,10,16,14,16,800,82,189,69,611,96,22676
3676,3676,15000US061110014021,667,105,27,42,27,42,0,12,640,104,98,56,542,93,22677
3677,3677,15000US061110014022,940,117,73,52,60,47,13,22,867,132,173,91,694,144,22678
3678,3678,15000US061110014023,445,84,15,25,15,25,0,12,430,86,85,45,345,93,22679
3679,3679,15000US061110015021,1210,189,75,58,13,21,62,60,1135,193,251,132,884,187,22680
3680,3680,15000US061110015022,692,145,88,79,21,33,67,72,604,167,115,72,489,159,22681
3681,3681,15000US061110015023,889,168,126,97,90,95,36,57,763,159,153,73,610,151,22682
3682,3682,15000US061110015024,902,144,92,62,17,26,75,56,810,149,111,71,699,139,22683
3683,3683,15000US061110015031,1059,123,77,56,45,41,32,39,982,130,173,54,809,136,22684
3684,3684,15000US061110015032,535,99,100,62,54,52,46,32,435,109,92,55,343,105,22685
3685,3685,15000US061110015033,199,90,7,11,7,11,0,12,192,88,30,31,162,86,22686
3686,3686,15000US061110015061,853,99,59,48,0,12,59,48,794,99,236,73,558,118,22687
3687,3687,15000US061110015062,346,56,20,23,11,18,9,14,326,57,110,50,216,57,22688
3688,3688,15000US061110015063,551,82,16,18,16,18,0,12,535,79,95,56,440,71,22689
3689,3689,15000US061110015071,288,72,32,41,24,38,8,14,256,67,29,27,227,73,22690
3690,3690,15000US061110015072,638,94,0,12,0,12,0,12,638,94,84,45,554,100,22691
3691,3691,15000US061110015073,552,98,132,67,65,47,67,49,420,100,21,24,399,102,22692
3692,3692,15000US061110016011,518,23,28,22,6,9,22,20,490,31,55,26,435,39,22693
3693,3693,15000US061110016021,626,45,51,34,21,20,30,28,575,48,207,40,368,52,22694
3694,3694,15000US061110016022,297,40,5,7,5,7,0,12,292,41,57,27,235,42,22695
3695,3695,15000US061110017001,957,85,7,11,7,11,0,12,950,84,244,71,706,107,22696
3696,3696,15000US061110017002,297,58,9,14,9,14,0,12,288,59,55,34,233,65,22697
3697,3697,15000US061110018001,252,56,6,10,0,12,6,10,246,57,81,55,165,54,22698
3698,3698,15000US061110018002,692,81,5,9,5,9,0,12,687,82,200,62,487,87,22699
3699,3699,15000US061110018003,286,49,9,15,0,12,9,15,277,49,61,28,216,54,22700
3700,3700,15000US061110018004,300,48,0,12,0,12,0,12,300,48,67,35,233,55,22701
3701,3701,15000US061110019001,282,62,40,39,34,37,6,11,242,55,45,31,197,58,22702
3702,3702,15000US061110019002,587,75,23,25,0,12,23,25,564,79,114,53,450,79,22703
3703,3703,15000US061110019003,180,60,0,12,0,12,0,12,180,60,48,28,132,62,22704
3704,3704,15000US061110019004,367,63,0,12,0,12,0,12,367,63,95,54,272,67,22705
3705,3705,15000US061110019005,258,68,0,12,0,12,0,12,258,68,79,39,179,78,22706
3706,3706,15000US061110020001,357,65,0,12,0,12,0,12,357,65,27,25,330,67,22707
3707,3707,15000US061110020002,356,56,9,13,9,13,0,12,347,58,46,28,301,61,22708
3708,3708,15000US061110020003,376,58,7,13,0,12,7,13,369,59,45,27,324,64,22709
3709,3709,15000US061110021021,991,78,66,45,66,45,0,12,925,93,135,61,790,99,22710
3710,3710,15000US061110022001,863,150,206,122,116,104,90,80,657,159,201,114,456,164,22711
3711,3711,15000US061110022002,366,138,73,65,0,12,73,65,293,125,106,94,187,86,22712
3712,3712,15000US061110022003,848,144,48,58,48,58,0,12,800,141,155,94,645,146,22713
3713,3713,15000US061110023001,850,174,45,64,45,64,0,12,805,172,289,115,516,180,22714
3714,3714,15000US061110023002,415,125,103,103,32,50,71,90,312,103,43,41,269,107,22715
3715,3715,15000US061110023003,447,119,24,27,13,23,11,17,423,119,168,117,255,122,22716
3716,3716,15000US061110023004,378,129,38,34,14,21,24,27,340,130,73,68,267,112,22717
3717,3717,15000US061110024001,567,103,55,48,30,24,25,40,512,110,254,87,258,83,22718
3718,3718,15000US061110024002,790,91,63,40,14,16,49,32,727,103,115,52,612,100,22719
3719,3719,15000US061110025001,605,158,16,26,0,12,16,26,589,157,10,18,579,155,22720
3720,3720,15000US061110025002,551,111,0,12,0,12,0,12,551,111,163,66,388,111,22721
3721,3721,15000US061110025003,232,80,0,12,0,12,0,12,232,80,41,39,191,78,22722
3722,3722,15000US061110025004,773,147,0,12,0,12,0,12,773,147,206,91,567,156,22723
3723,3723,15000US061110026001,368,83,50,52,10,16,40,49,318,75,42,29,276,72,22724
3724,3724,15000US061110026002,741,91,16,20,0,12,16,20,725,94,115,48,610,97,22725
3725,3725,15000US061110026003,255,66,15,17,15,17,0,12,240,69,13,18,227,69,22726
3726,3726,15000US061110027001,522,81,57,38,33,29,24,26,465,86,129,56,336,81,22727
3727,3727,15000US061110027002,1105,94,16,18,7,12,9,15,1089,94,480,112,609,106,22728
3728,3728,15000US061110028001,943,154,169,109,42,40,127,103,774,159,152,70,622,153,22729
3729,3729,15000US061110028002,381,83,0,12,0,12,0,12,381,83,70,46,311,88,22730
3730,3730,15000US061110028003,400,100,0,12,0,12,0,12,400,100,111,58,289,95,22731
3731,3731,15000US061110028004,602,109,52,66,52,66,0,12,550,108,22,27,528,106,22732
3732,3732,15000US061110028005,180,87,57,57,0,12,57,57,123,82,14,22,109,82,22733
3733,3733,15000US061110029011,1248,92,77,59,37,44,40,39,1171,99,288,92,883,106,22734
3734,3734,15000US061110029012,526,84,72,60,33,46,39,35,454,73,180,72,274,70,22735
3735,3735,15000US061110029051,786,98,62,59,10,16,52,57,724,98,211,71,513,85,22736
3736,3736,15000US061110029052,829,100,55,34,25,23,30,26,774,100,203,69,571,123,22737
3737,3737,15000US061110030101,982,50,94,45,31,25,63,37,888,70,210,54,678,83,22738
3738,3738,15000US061110030111,906,100,92,54,56,50,36,44,814,109,242,84,572,125,22739
3739,3739,15000US061110030112,674,105,197,88,33,32,164,85,477,97,174,72,303,92,22740
3740,3740,15000US061110030121,148,95,40,64,40,64,0,12,108,77,10,17,98,75,22741
3741,3741,15000US061110030131,481,94,8,13,8,13,0,12,473,93,87,50,386,89,22742
3742,3742,15000US061110030132,1117,94,94,66,20,22,74,62,1023,104,319,133,704,131,22743
3743,3743,15000US061110031001,1264,170,85,82,34,54,51,66,1179,177,465,146,714,167,22744
3744,3744,15000US061110031002,2187,191,133,92,52,56,81,75,2054,197,308,127,1746,214,22745
3745,3745,15000US061110032011,363,59,147,49,32,32,115,48,216,55,29,22,187,56,22746
3746,3746,15000US061110032012,395,58,97,46,36,34,61,37,298,57,70,28,228,65,22747
3747,3747,15000US061110033001,465,122,0,12,0,12,0,12,465,122,68,50,397,128,22748
3748,3748,15000US061110033002,547,117,13,21,0,12,13,21,534,116,83,57,451,124,22749
3749,3749,15000US061110033003,483,113,178,97,82,58,96,81,305,102,81,47,224,89,22750
3750,3750,15000US061110033004,336,111,9,19,0,12,9,19,327,113,71,46,256,112,22751
3751,3751,15000US061110033005,388,97,61,56,30,35,31,46,327,106,68,41,259,112,22752
3752,3752,15000US061110036051,1034,146,15,31,6,22,9,18,1019,149,264,98,755,167,22753
3753,3753,15000US061110036052,1236,180,101,96,71,89,30,35,1135,196,255,111,880,177,22754
3754,3754,15000US061110036053,560,125,73,52,48,45,25,28,487,129,218,97,269,107,22755
3755,3755,15000US061110036081,1007,41,58,34,13,14,45,32,949,50,271,53,678,70,22756
3756,3756,15000US061110036091,1473,181,49,73,49,73,0,12,1424,180,242,129,1182,205,22757
3757,3757,15000US061110036092,689,134,0,12,0,12,0,12,689,134,234,83,455,127,22758
3758,3758,15000US061110036093,847,155,40,65,40,65,0,12,807,147,129,70,678,143,22759
3759,3759,15000US061110036121,0,12,0,12,0,12,0,12,0,12,0,12,0,12,22760
3760,3760,15000US061110036122,982,202,0,12,0,12,0,12,982,202,236,114,746,190,22761
3761,3761,15000US061110036123,977,170,15,23,15,23,0,12,962,171,239,104,723,160,22762
3762,3762,15000US061110037001,564,85,99,48,38,36,61,37,465,94,180,73,285,73,22763
3763,3763,15000US061110037002,639,70,116,67,69,54,47,42,523,81,228,70,295,81,22764
3764,3764,15000US061110038011,328,100,122,87,48,70,74,49,206,78,69,44,137,75,22765
3765,3765,15000US061110038012,808,122,166,100,65,80,101,80,642,132,151,92,491,116,22766
3766,3766,15000US061110038021,556,31,167,51,14,16,153,52,389,56,78,32,311,61,22767
3767,3767,15000US061110039001,631,114,223,102,55,53,168,94,408,100,136,60,272,84,22768
3768,3768,15000US061110039002,829,110,174,73,71,64,103,64,655,109,210,78,445,99,22769
3769,3769,15000US061110040001,308,94,44,49,0,12,44,49,264,80,68,32,196,73,22770
3770,3770,15000US061110040002,403,87,70,44,17,19,53,39,333,86,26,21,307,87,22771
3771,3771,15000US061110040003,284,78,82,53,54,52,28,12,202,86,31,25,171,85,22772
3772,3772,15000US061110040004,414,99,18,22,0,12,18,22,396,100,148,78,248,85,22773
3773,3773,15000US061110041011,531,105,175,84,66,51,109,64,356,100,122,56,234,92,22774
3774,3774,15000US061110041012,393,85,41,37,20,21,21,31,352,82,71,45,281,84,22775
3775,3775,15000US061110041013,416,85,51,46,21,32,30,35,365,87,122,66,243,88,22776
3776,3776,15000US061110042001,467,80,20,16,14,16,6,10,447,79,86,56,361,81,22777
3777,3777,15000US061110042002,434,78,66,56,50,54,16,18,368,86,198,81,170,56,22778
3778,3778,15000US061110042003,320,59,52,36,23,28,29,27,268,67,116,57,152,60,22779
3779,3779,15000US061110043041,309,106,57,49,46,55,11,18,252,99,97,75,155,81,22780
3780,3780,15000US061110043042,843,152,56,65,47,58,9,18,787,161,269,94,518,151,22781
3781,3781,15000US061110043043,777,141,27,32,0,12,27,32,750,146,157,90,593,134,22782
3782,3782,15000US061110043044,504,133,179,110,54,54,125,100,325,97,75,66,250,96,22783
3783,3783,15000US061110043051,400,69,13,16,0,12,13,16,387,71,36,23,351,68,22784
3784,3784,15000US061110044001,608,135,38,40,14,23,24,34,570,138,194,96,376,136,22785
3785,3785,15000US061110044002,521,136,69,52,0,12,69,52,452,146,99,78,353,135,22786
3786,3786,15000US061110044003,341,135,14,22,0,12,14,22,327,136,78,46,249,127,22787
3787,3787,15000US061110044004,1202,209,115,74,39,66,76,63,1087,214,216,100,871,213,22788
3788,3788,15000US061110045031,278,84,38,44,3,6,35,44,240,81,44,41,196,78,22789
3789,3789,15000US061110045032,704,103,92,52,67,49,25,29,612,110,115,56,497,119,22790
3790,3790,15000US061110045041,668,89,153,68,82,57,71,48,515,96,125,59,390,87,22791
3791,3791,15000US061110045042,488,85,45,53,14,20,31,43,443,98,110,42,333,104,22792
3792,3792,15000US061110045051,447,40,36,23,21,20,15,16,411,42,124,48,287,49,22793
3793,3793,15000US061110045061,730,94,221,88,66,61,155,71,509,95,20,19,489,97,22794
3794,3794,15000US061110045062,371,76,159,60,82,48,77,51,212,81,14,22,198,79,22795
3795,3795,15000US061110045063,355,70,128,62,29,34,99,54,227,70,52,39,175,66,22796
3796,3796,15000US061110046001,520,57,17,21,5,9,12,18,503,58,40,25,463,60,22797
3797,3797,15000US061110047041,111,33,4,7,4,7,0,12,107,32,15,20,92,36,22798
3798,3798,15000US061110047042,310,41,47,36,17,16,30,29,263,51,85,25,178,52,22799
3799,3799,15000US061110047101,576,121,106,69,55,53,51,43,470,119,117,61,353,116,22800
3800,3800,15000US061110047102,504,118,108,72,9,14,99,71,396,120,136,60,260,107,22801
3801,3801,15000US061110047103,177,57,0,12,0,12,0,12,177,57,44,42,133,47,22802
3802,3802,15000US061110047111,360,48,82,35,43,33,39,29,278,48,84,43,194,53,22803
3803,3803,15000US061110047112,422,51,20,18,9,12,11,15,402,50,139,45,263,53,22804
3804,3804,15000US061110047151,623,80,120,68,26,34,94,57,503,86,269,78,234,87,22805
3805,3805,15000US061110047152,609,80,112,49,45,31,67,40,497,89,164,69,333,84,22806
3806,3806,15000US061110047161,377,57,27,26,3,5,24,25,350,58,98,34,252,58,22807
3807,3807,15000US061110047162,525,55,72,40,39,27,33,29,453,64,133,47,320,63,22808
3808,3808,15000US061110047171,383,52,34,23,21,17,13,16,349,56,85,41,264,65,22809
3809,3809,15000US061110047172,336,49,53,38,27,28,26,29,283,58,121,53,162,47,22810
3810,3810,15000US061110049011,1773,55,112,56,43,35,69,51,1661,70,271,85,1390,105,22811
3811,3811,15000US061110049021,652,127,115,52,16,19,99,50,537,123,192,73,345,108,22812
3812,3812,15000US061110049022,460,108,101,76,0,12,101,76,359,94,163,66,196,82,22813
3813,3813,15000US061110050021,712,35,171,58,66,39,105,49,541,58,157,53,384,68,22814
3814,3814,15000US061110050031,690,115,86,57,14,17,72,54,604,121,218,84,386,115,22815
3815,3815,15000US061110050032,1191,124,171,81,116,68,55,41,1020,130,357,102,663,119,22816
3816,3816,15000US061110050041,2325,120,295,133,19,22,276,130,2030,170,294,125,1736,158,22817
3817,3817,15000US061110051001,242,51,0,12,0,12,0,12,242,51,73,45,169,45,22818
3818,3818,15000US061110051002,216,46,19,28,0,12,19,28,197,50,79,40,118,43,22819
3819,3819,15000US061110051003,618,69,5,8,0,12,5,8,613,70,139,53,474,69,22820
3820,3820,15000US061110052021,301,63,24,27,10,17,14,21,277,64,79,45,198,52,22821
3821,3821,15000US061110052022,819,64,45,39,39,38,6,10,774,73,139,48,635,81,22822
3822,3822,15000US061110052031,916,104,0,12,0,12,0,12,916,104,234,80,682,120,22823
3823,3823,15000US061110052032,673,86,28,39,4,8,24,38,645,83,127,42,518,91,22824
3824,3824,15000US061110052033,271,55,11,18,11,18,0,12,260,56,60,49,200,48,22825
3825,3825,15000US061110052041,720,62,0,12,0,12,0,12,720,62,195,70,525,75,22826
3826,3826,15000US061110052042,535,64,9,13,9,13,0,12,526,66,194,61,332,73,22827
3827,3827,15000US061110052051,879,112,12,19,12,19,0,12,867,114,205,64,662,124,22828
3828,3828,15000US061110052052,1375,106,83,83,20,34,63,78,1292,122,272,95,1020,146,22829
3829,3829,15000US061110053031,2160,141,0,17,0,17,0,17,2160,141,405,117,1755,164,22830
3830,3830,15000US061110053032,1099,136,30,32,30,32,0,12,1069,137,290,137,779,131,22831
3831,3831,15000US061110053041,1370,160,14,22,0,12,14,22,1356,165,759,161,597,157,22832
3832,3832,15000US061110053042,684,131,49,53,49,53,0,12,635,134,255,120,380,126,22833
3833,3833,15000US061110053043,660,137,18,28,18,28,0,12,642,137,163,73,479,137,22834
3834,3834,15000US061110053051,935,96,0,12,0,12,0,12,935,96,158,65,777,98,22835
3835,3835,15000US061110053052,876,84,0,12,0,12,0,12,876,84,139,58,737,97,22836
3836,3836,15000US061110053061,673,63,0,12,0,12,0,12,673,63,156,52,517,73,22837
3837,3837,15000US061110053062,967,68,31,35,0,12,31,35,936,72,150,55,786,88,22838
3838,3838,15000US061110054011,585,66,27,28,17,25,10,15,558,63,126,41,432,70,22839
3839,3839,15000US061110054012,725,71,29,38,0,12,29,38,696,78,107,44,589,78,22840
3840,3840,15000US061110054031,954,44,132,51,73,43,59,32,822,68,209,56,613,82,22841
3841,3841,15000US061110054041,628,86,5,12,0,12,5,12,623,84,190,66,433,86,22842
3842,3842,15000US061110054042,528,92,14,24,0,12,14,24,514,86,158,64,356,81,22843
3843,3843,15000US061110055021,534,106,48,59,0,12,48,59,486,107,144,79,342,104,22844
3844,3844,15000US061110055022,619,128,14,27,0,12,14,27,605,128,53,64,552,125,22845
3845,3845,15000US061110055023,918,148,92,88,65,76,27,42,826,153,61,49,765,149,22846
3846,3846,15000US061110055031,770,81,24,22,9,14,15,16,746,85,225,70,521,82,22847
3847,3847,15000US061110055032,548,79,2,6,2,6,0,12,546,78,200,74,346,64,22848
3848,3848,15000US061110055041,714,84,13,20,13,20,0,12,701,88,187,59,514,91,22849
3849,3849,15000US061110055042,838,85,10,15,0,12,10,15,828,86,288,77,540,95,22850
3850,3850,15000US061110056001,1105,177,76,78,16,25,60,74,1029,182,124,67,905,181,22851
3851,3851,15000US061110056002,997,156,27,33,13,20,14,24,970,154,279,104,691,156,22852
3852,3852,15000US061110056003,1725,138,44,35,18,24,26,31,1681,140,325,121,1356,151,22853
3853,3853,15000US061110057001,580,40,0,12,0,12,0,12,580,40,68,28,512,48,22854
3854,3854,15000US061110058011,251,53,8,14,8,14,0,12,243,54,56,30,187,53,22855
3855,3855,15000US061110058012,729,77,12,19,12,19,0,12,717,78,54,34,663,86,22856
3856,3856,15000US061110058013,724,73,5,9,5,9,0,12,719,74,99,50,620,68,22857
3857,3857,15000US061110058021,932,105,0,12,0,12,0,12,932,105,127,82,805,123,22858
3858,3858,15000US061110058022,1561,138,18,28,0,17,18,28,1543,139,198,105,1345,141,22859
3859,3859,15000US061110058023,520,120,15,24,15,24,0,12,505,121,145,94,360,134,22860
3860,3860,15000US061110059011,455,128,0,12,0,12,0,12,455,128,99,58,356,143,22861
3861,3861,15000US061110059012,614,150,0,12,0,12,0,12,614,150,145,74,469,138,22862
3862,3862,15000US061110059013,423,87,0,12,0,12,0,12,423,87,27,33,396,96,22863
3863,3863,15000US061110059014,215,85,0,12,0,12,0,12,215,85,74,44,141,85,22864
3864,3864,15000US061110059015,597,128,0,12,0,12,0,12,597,128,9,15,588,130,22865
3865,3865,15000US061110059061,540,89,0,12,0,12,0,12,540,89,141,73,399,87,22866
3866,3866,15000US061110059062,1228,147,0,12,0,12,0,12,1228,147,184,78,1044,154,22867
3867,3867,15000US061110059063,475,111,0,12,0,12,0,12,475,111,54,39,421,113,22868
3868,3868,15000US061110059064,216,66,0,12,0,12,0,12,216,66,33,28,183,66,22869
3869,3869,15000US061110059071,806,109,0,12,0,12,0,12,806,109,170,79,636,112,22870
3870,3870,15000US061110059072,422,74,10,15,10,15,0,12,412,77,62,31,350,88,22871
3871,3871,15000US061110059073,547,75,17,20,8,14,9,14,530,76,132,59,398,83,22872
3872,3872,15000US061110059081,439,55,22,22,13,20,9,11,417,53,95,38,322,60,22873
3873,3873,15000US061110059082,495,57,5,8,0,12,5,8,490,58,86,40,404,64,22874
3874,3874,15000US061110059091,968,88,178,92,60,53,118,80,790,122,147,61,643,122,22875
3875,3875,15000US061110059092,514,74,30,47,30,47,0,12,484,71,126,61,358,76,22876
3876,3876,15000US061110059101,609,29,5,7,0,12,5,7,604,29,80,37,524,43,22877
3877,3877,15000US061110059111,786,108,18,21,0,12,18,21,768,107,68,44,700,114,22878
3878,3878,15000US061110059112,205,51,0,12,0,12,0,12,205,51,32,22,173,52,22879
3879,3879,15000US061110059113,506,72,6,9,0,12,6,9,500,71,75,35,425,79,22880
3880,3880,15000US061110060001,426,80,12,19,0,12,12,19,414,80,80,52,334,74,22881
3881,3881,15000US061110060002,595,92,8,13,0,12,8,13,587,91,145,70,442,92,22882
3882,3882,15000US061110060003,511,88,8,14,0,12,8,14,503,90,121,54,382,94,22883
3883,3883,15000US061110061001,1243,154,0,12,0,12,0,12,1243,154,278,116,965,132,22884
3884,3884,15000US061110061002,148,76,0,12,0,12,0,12,148,76,13,20,135,80,22885
3885,3885,15000US061110061003,292,119,79,62,0,12,79,62,213,126,116,85,97,94,22886
3886,3886,15000US061110061004,1127,164,88,106,0,12,88,106,1039,187,108,110,931,189,22887
3887,3887,15000US061110062001,813,74,27,26,16,18,11,17,786,77,190,69,596,96,22888
3888,3888,15000US061110062002,229,60,0,12,0,12,0,12,229,60,50,28,179,68,22889
3889,3889,15000US061110063011,1168,135,0,12,0,12,0,12,1168,135,441,129,727,149,22890
3890,3890,15000US061110063012,951,96,18,27,18,27,0,12,933,97,158,82,775,125,22891
3891,3891,15000US061110063013,487,97,0,12,0,12,0,12,487,97,105,52,382,90,22892
3892,3892,15000US061110063021,368,40,18,28,0,12,18,28,350,43,64,34,286,43,22893
3893,3893,15000US061110063022,452,38,0,12,0,12,0,12,452,38,77,32,375,45,22894
3894,3894,15000US061110064001,731,109,0,12,0,12,0,12,731,109,190,94,541,113,22895
3895,3895,15000US061110064002,639,102,0,12,0,12,0,12,639,102,125,75,514,105,22896
3896,3896,15000US061110064003,384,85,0,12,0,12,0,12,384,85,159,91,225,72,22897
3897,3897,15000US061110064004,219,92,26,40,26,40,0,12,193,83,32,30,161,81,22898
3898,3898,15000US061110064005,519,128,16,25,0,12,16,25,503,130,71,60,432,157,22899
3899,3899,15000US061110065001,361,55,8,12,8,12,0,12,353,57,68,38,285,54,22900
3900,3900,15000US061110065002,658,80,78,65,22,25,56,61,580,72,142,59,438,87,22901
3901,3901,15000US061110066001,532,66,17,19,10,16,7,11,515,64,135,47,380,73,22902
3902,3902,15000US061110066002,619,75,15,17,9,14,6,10,604,79,206,73,398,96,22903
3903,3903,15000US061110066003,213,39,0,12,0,12,0,12,213,39,15,17,198,43,22904
3904,3904,15000US061110067001,201,43,0,12,0,12,0,12,201,43,20,18,181,48,22905
3905,3905,15000US061110067002,949,57,5,9,5,9,0,12,944,59,204,83,740,96,22906
3906,3906,15000US061110068001,426,74,10,16,10,16,0,12,416,74,142,65,274,68,22907
3907,3907,15000US061110068002,441,80,31,37,10,14,21,34,410,72,91,41,319,69,22908
3908,3908,15000US061110068003,330,77,0,12,0,12,0,12,330,77,50,32,280,81,22909
3909,3909,15000US061110069001,700,114,52,47,0,12,52,47,648,111,191,74,457,99,22910
3910,3910,15000US061110069002,1055,107,59,59,33,50,26,33,996,119,219,70,777,114,22911
3911,3911,15000US061110070001,930,112,76,55,26,30,50,46,854,116,241,84,613,106,22912
3912,3912,15000US061110070002,663,99,107,54,45,41,62,48,556,98,221,78,335,74,22913
3913,3913,15000US061110071001,659,166,90,107,0,12,90,107,569,156,252,109,317,145,22914
3914,3914,15000US061110071002,1133,179,116,90,0,12,116,90,1017,189,267,123,750,162,22915
3915,3915,15000US061110071003,890,164,27,33,17,28,10,16,863,167,261,126,602,152,22916
3916,3916,15000US061110072011,343,48,0,12,0,12,0,12,343,48,62,33,281,52,22917
3917,3917,15000US061110072012,551,63,0,12,0,12,0,12,551,63,222,65,329,68,22918
3918,3918,15000US061110072013,307,48,0,12,0,12,0,12,307,48,34,28,273,48,22919
3919,3919,15000US061110072021,928,84,20,22,10,17,10,15,908,86,200,70,708,94,22920
3920,3920,15000US061110072022,659,75,0,12,0,12,0,12,659,75,131,60,528,85,22921
3921,3921,15000US061110073001,774,62,0,12,0,12,0,12,774,62,75,32,699,67,22922
3922,3922,15000US061110074021,865,117,12,19,12,19,0,12,853,119,159,87,694,116,22923
3923,3923,15000US061110074022,898,117,0,12,0,12,0,12,898,117,122,83,776,139,22924
3924,3924,15000US061110074023,820,114,0,12,0,12,0,12,820,114,116,60,704,125,22925
3925,3925,15000US061110074031,441,95,0,12,0,12,0,12,441,95,46,41,395,95,22926
3926,3926,15000US061110074032,867,131,16,26,0,12,16,26,851,132,136,87,715,135,22927
3927,3927,15000US061110074033,875,118,0,12,0,12,0,12,875,118,183,92,692,130,22928
3928,3928,15000US061110074051,1567,169,84,87,0,12,84,87,1483,156,189,104,1294,176,22929
3929,3929,15000US061110074052,447,112,15,23,15,23,0,12,432,112,135,94,297,92,22930
3930,3930,15000US061110074053,439,119,0,12,0,12,0,12,439,119,13,19,426,122,22931
3931,3931,15000US061110074061,854,36,17,16,11,13,6,10,837,44,74,32,763,45,22932
3932,3932,15000US061110075051,487,82,17,21,17,21,0,12,470,85,153,89,317,82,22933
3933,3933,15000US061110075052,649,85,20,33,2,5,18,34,629,78,260,71,369,79,22934
3934,3934,15000US061110075061,445,79,18,35,18,35,0,12,427,80,33,35,394,77,22935
3935,3935,15000US061110075062,550,126,0,12,0,12,0,12,550,126,113,101,437,114,22936
3936,3936,15000US061110075063,320,85,17,28,0,12,17,28,303,89,45,45,258,98,22937
3937,3937,15000US061110075064,782,110,0,12,0,12,0,12,782,110,93,53,689,118,22938
3938,3938,15000US061110075065,388,100,0,12,0,12,0,12,388,100,50,50,338,88,22939
3939,3939,15000US061110075071,773,123,0,12,0,12,0,12,773,123,117,91,656,108,22940
3940,3940,15000US061110075072,306,73,18,30,0,12,18,30,288,68,28,22,260,70,22941
3941,3941,15000US061110075073,1274,115,0,12,0,12,0,12,1274,115,221,86,1053,126,22942
3942,3942,15000US061110075081,401,61,0,12,0,12,0,12,401,61,154,61,247,61,22943
3943,3943,15000US061110075082,1037,72,94,59,17,19,77,57,943,91,168,79,775,117,22944
3944,3944,15000US061110075091,602,78,0,12,0,12,0,12,602,78,74,36,528,83,22945
3945,3945,15000US061110075092,914,89,22,26,22,26,0,12,892,90,186,75,706,104,22946
3946,3946,15000US061110075101,720,87,0,12,0,12,0,12,720,87,75,55,645,99,22947
3947,3947,15000US061110075102,672,109,0,12,0,12,0,12,672,109,104,72,568,123,22948
3948,3948,15000US061110075103,638,83,0,12,0,12,0,12,638,83,122,67,516,98,22949
3949,3949,15000US061110075111,601,41,0,12,0,12,0,12,601,41,134,49,467,56,22950
3950,3950,15000US061110075112,228,38,13,15,13,15,0,12,215,42,42,22,173,41,22951
3951,3951,15000US061110075121,1070,91,87,55,41,42,46,34,983,107,196,70,787,110,22952
3952,3952,15000US061110075122,688,85,0,12,0,12,0,12,688,85,132,71,556,93,22953
3953,3953,15000US061110075131,514,40,5,8,0,12,5,8,509,41,129,40,380,47,22954
3954,3954,15000US061110075141,731,135,13,21,13,21,0,12,718,132,250,117,468,149,22955
3955,3955,15000US061110075142,868,157,0,12,0,12,0,12,868,157,164,104,704,161,22956
3956,3956,15000US061110075143,1295,166,37,43,0,12,37,43,1258,167,365,129,893,158,22957
3957,3957,15000US061110076061,431,29,0,12,0,12,0,12,431,29,99,36,332,38,22958
3958,3958,15000US061110076071,978,117,0,12,0,12,0,12,978,117,117,68,861,133,22959
3959,3959,15000US061110076072,1006,134,0,12,0,12,0,12,1006,134,130,95,876,159,22960
3960,3960,15000US061110076091,821,33,23,18,11,12,12,14,798,36,133,44,665,52,22961
3961,3961,15000US061110076101,838,81,11,19,11,19,0,12,827,81,210,77,617,97,22962
3962,3962,15000US061110076102,926,76,19,20,0,12,19,20,907,78,158,56,749,86,22963
3963,3963,15000US061110076111,728,64,91,56,26,21,65,53,637,77,98,49,539,77,22964
3964,3964,15000US061110076112,182,56,18,19,10,13,8,13,164,59,43,39,121,48,22965
3965,3965,15000US061110076121,1078,97,170,87,88,67,82,61,908,110,227,88,681,126,22966
3966,3966,15000US061110076122,615,88,36,39,8,13,28,36,579,96,69,48,510,100,22967
3967,3967,15000US061110076131,688,101,17,19,0,12,17,19,671,103,104,57,567,105,22968
3968,3968,15000US061110076132,526,81,0,12,0,12,0,12,526,81,65,34,461,80,22969
3969,3969,15000US061110076141,485,108,38,62,0,12,38,62,447,105,132,72,315,108,22970
3970,3970,15000US061110076142,697,117,0,12,0,12,0,12,697,117,54,51,643,121,22971
3971,3971,15000US061110076143,454,95,0,12,0,12,0,12,454,95,30,34,424,95,22972
3972,3972,15000US061110076144,786,110,25,28,15,24,10,16,761,111,221,109,540,111,22973
3973,3973,15000US061110077001,861,109,9,15,0,12,9,15,852,109,228,86,624,109,22974
3974,3974,15000US061110077002,667,122,101,64,36,34,65,54,566,121,93,61,473,111,22975
3975,3975,15000US061110077003,490,99,0,12,0,12,0,12,490,99,127,66,363,83,22976
3976,3976,15000US061110078001,997,133,191,96,64,45,127,78,806,109,153,64,653,119,22977
3977,3977,15000US061110078002,421,88,65,47,18,27,47,38,356,88,73,39,283,88,22978
3978,3978,15000US061110079011,926,89,49,40,17,29,32,31,877,94,158,70,719,92,22979
3979,3979,15000US061110079012,295,58,17,19,7,11,10,15,278,62,127,56,151,58,22980
3980,3980,15000US061110079013,508,83,29,31,29,31,0,12,479,85,73,52,406,77,22981
3981,3981,15000US061110079031,1546,41,22,19,7,13,15,16,1524,47,284,70,1240,76,22982
3982,3982,15000US061110079041,505,89,7,11,0,12,7,11,498,91,90,39,408,92,22983
3983,3983,15000US061110079042,330,64,0,12,0,12,0,12,330,64,84,44,246,70,22984
3984,3984,15000US061110079043,467,82,16,17,0,12,16,17,451,84,177,79,274,82,22985
3985,3985,15000US061110079044,232,61,29,45,0,12,29,45,203,67,107,57,96,49,22986
3986,3986,15000US061110079045,218,78,28,42,0,12,28,42,190,73,55,35,135,67,22987
3987,3987,15000US061110080011,390,62,16,15,12,13,4,7,374,66,134,54,240,55,22988
3988,3988,15000US061110080012,580,62,71,46,32,28,39,38,509,61,154,59,355,65,22989
3989,3989,15000US061110080021,498,105,19,29,0,12,19,29,479,106,118,79,361,84,22990
3990,3990,15000US061110080022,806,99,53,47,0,12,53,47,753,101,182,74,571,103,22991
3991,3991,15000US061110080023,272,79,11,17,11,17,0,12,261,82,53,56,208,85,22992
3992,3992,15000US061110080041,532,80,8,12,8,12,0,12,524,80,128,64,396,87,22993
3993,3993,15000US061110080042,386,81,27,25,27,25,0,12,359,83,61,41,298,87,22994
3994,3994,15000US061110080043,240,72,29,22,9,15,20,19,211,74,43,28,168,75,22995
3995,3995,15000US061110080044,271,61,6,10,6,10,0,12,265,63,118,50,147,63,22996
3996,3996,15000US061110080051,488,44,27,20,0,12,27,20,461,50,101,40,360,59,22997
3997,3997,15000US061110080052,249,45,14,16,0,12,14,16,235,45,51,23,184,44,22998
3998,3998,15000US061110081011,635,61,31,22,4,10,27,25,604,63,115,56,489,67,22999
3999,3999,15000US061110081012,468,64,0,12,0,12,0,12,468,64,142,45,326,73,23000
4000,4000,15000US061110082011,612,76,76,54,47,50,29,23,536,86,98,46,438,92,23001
4001,4001,15000US061110082012,843,78,39,33,17,19,22,28,804,83,95,46,709,94,23002
4002,4002,15000US061110082021,485,78,0,12,0,12,0,12,485,78,76,36,409,82,23003
4003,4003,15000US061110082022,382,66,7,11,0,12,7,11,375,67,88,50,287,72,23004
4004,4004,15000US061110082023,621,85,47,37,19,28,28,34,574,80,251,81,323,77,23005
4005,4005,15000US061110083021,718,105,42,43,0,12,42,43,676,104,108,56,568,111,23006
4006,4006,15000US061110083022,1315,111,65,47,43,44,22,19,1250,106,371,104,879,132,23007
4007,4007,15000US061110083031,235,67,4,10,0,12,4,10,231,66,80,52,151,55,23008
4008,4008,15000US061110083032,1101,87,58,40,34,32,24,23,1043,79,311,82,732,97,23009
4009,4009,15000US061110083041,757,136,26,21,26,21,0,12,731,134,177,94,554,150,23010
4010,4010,15000US061110083042,868,116,11,19,0,12,11,19,857,122,237,118,620,139,23011
4011,4011,15000US061110083043,486,96,6,10,0,12,6,10,480,96,39,40,441,98,23012
4012,4012,15000US061110083051,1210,58,0,12,0,12,0,12,1210,58,117,56,1093,78,23013
4013,4013,15000US061110083061,192,70,0,12,0,12,0,12,192,70,50,33,142,68,23014
4014,4014,15000US061110083062,586,86,0,12,0,12,0,12,586,86,57,47,529,84,23015
4015,4015,15000US061110083063,786,110,0,12,0,12,0,12,786,110,192,75,594,112,23016
4016,4016,15000US061110084011,858,87,15,18,7,13,8,13,843,87,287,91,556,95,23017
4017,4017,15000US061110084012,427,67,21,24,21,24,0,12,406,62,52,34,354,69,23018
4018,4018,15000US061110084013,576,89,91,74,51,50,40,55,485,87,76,39,409,95,23019
4019,4019,15000US061110084021,633,64,9,14,9,14,0,12,624,64,186,74,438,76,23020
4020,4020,15000US061110084022,493,72,0,12,0,12,0,12,493,72,116,46,377,80,23021
4021,4021,15000US061110084023,226,49,14,15,14,15,0,12,212,52,41,27,171,54,23022
4022,4022,15000US061110084024,282,51,10,16,10,16,0,12,272,52,54,40,218,64,23023
4023,4023,15000US061110085001,923,140,13,20,0,12,13,20,910,144,135,88,775,165,23024
4024,4024,15000US061110085002,847,130,20,29,0,12,20,29,827,135,209,83,618,147,23025
4025,4025,15000US061110085003,1301,170,25,32,17,27,8,14,1276,176,279,129,997,175,23026
4026,4026,15000US061110086001,872,140,245,111,13,22,232,110,627,143,138,77,489,142,23027
4027,4027,15000US061110086002,705,127,226,109,88,78,138,86,479,109,174,76,305,111,23028
4028,4028,15000US061110086003,199,62,10,15,10,15,0,12,189,61,31,40,158,52,23029
4029,4029,15000US061110086004,369,108,18,30,0,12,18,30,351,106,171,97,180,83,23030
4030,4030,15000US061110087001,439,71,33,34,26,31,7,13,406,66,101,51,305,64,23031
4031,4031,15000US061110087002,968,104,120,55,62,41,58,37,848,110,287,76,561,113,23032
4032,4032,15000US061110087003,469,97,94,54,48,43,46,45,375,96,181,78,194,80,23033
4033,4033,15000US061110088001,912,90,127,71,61,54,66,45,785,102,144,57,641,106,23034
4034,4034,15000US061110088002,482,78,85,72,59,54,26,33,397,88,101,55,296,91,23035
4035,4035,15000US061110089001,224,51,20,22,20,22,0,12,204,50,56,26,148,48,23036
4036,4036,15000US061110089002,460,58,98,51,21,19,77,48,362,66,195,64,167,59,23037
4037,4037,15000US061110091001,305,67,70,47,11,17,59,41,235,72,114,61,121,55,23038
4038,4038,15000US061110091002,312,74,100,63,74,55,26,31,212,70,107,54,105,51,23039
4039,4039,15000US061110091003,123,57,16,25,0,12,16,25,107,53,47,48,60,44,23040
4040,4040,15000US061110091004,355,82,147,74,87,57,60,53,208,71,91,54,117,47,23041
4041,4041,15000US061119800001,0,12,0,12,0,12,0,12,0,12,0,12,0,12,23042
4042,4042,15000US061119901000,0,12,0,12,0,12,0,12,0,12,0,12,0,12,23043
4043,4043,15000US061130101011,460,125,33,36,16,25,17,26,427,124,75,60,352,109,23044
4044,4044,15000US061130101012,510,120,90,88,24,37,66,80,420,117,175,88,245,119,23045
4045,4045,15000US061130101013,1048,154,144,102,64,54,80,89,904,175,200,81,704,165,23046
4046,4046,15000US061130101014,448,142,168,83,59,64,109,84,280,116,95,84,185,99,23047
4047,4047,15000US061130101021,677,145,121,77,30,36,91,70,556,135,259,120,297,116,23048
4048,4048,15000US061130101022,461,117,118,66,40,42,78,55,343,117,166,83,177,92,23049
4049,4049,15000US061130101023,209,67,14,22,14,22,0,12,195,68,22,24,173,68,23050
4050,4050,15000US061130101024,1061,144,280,142,203,140,77,45,781,176,259,116,522,160,23051
4051,4051,15000US061130102011,911,88,156,64,21,32,135,64,755,107,131,60,624,108,23052
4052,4052,15000US061130102012,416,79,69,69,0,12,69,69,347,73,117,62,230,75,23053
4053,4053,15000US061130102031,569,160,23,33,0,12,23,33,546,157,84,94,462,136,23054
4054,4054,15000US061130102032,718,181,209,113,136,102,73,54,509,169,226,144,283,127,23055
4055,4055,15000US061130102033,522,157,184,119,89,79,95,97,338,121,152,90,186,103,23056
4056,4056,15000US061130102034,197,74,12,20,12,20,0,12,185,70,44,43,141,67,23057
4057,4057,15000US061130102041,1121,196,225,130,97,78,128,96,896,199,307,129,589,222,23058
4058,4058,15000US061130102042,397,112,121,120,0,12,121,120,276,97,117,75,159,90,23059
4059,4059,15000US061130102043,427,114,13,30,13,30,0,12,414,112,230,86,184,70,23060
4060,4060,15000US061130103021,613,114,31,34,19,29,12,19,582,125,148,102,434,150,23061
4061,4061,15000US061130103022,680,128,0,12,0,12,0,12,680,128,103,58,577,128,23062
4062,4062,15000US061130103023,1519,169,49,37,12,20,37,33,1470,174,244,105,1226,190,23063
4063,4063,15000US061130103101,1100,107,56,42,11,15,45,40,1044,111,204,90,840,119,23064
4064,4064,15000US061130103102,431,64,0,12,0,12,0,12,431,64,98,64,333,70,23065
4065,4065,15000US061130103103,224,48,0,12,0,12,0,12,224,48,51,35,173,48,23066
4066,4066,15000US061130103121,1080,85,68,41,35,37,33,30,1012,98,107,55,905,108,23067
4067,4067,15000US061130103122,586,84,23,25,0,12,23,25,563,89,195,70,368,85,23068
4068,4068,15000US061130103123,225,57,0,12,0,12,0,12,225,57,66,34,159,55,23069
4069,4069,15000US061130104011,334,65,0,12,0,12,0,12,334,65,51,32,283,64,23070
4070,4070,15000US061130104012,1036,101,48,45,7,12,41,43,988,103,122,59,866,104,23071
4071,4071,15000US061130104013,436,88,19,23,0,12,19,23,417,88,86,43,331,85,23072
4072,4072,15000US061130104021,639,75,11,17,0,12,11,17,628,74,142,55,486,75,23073
4073,4073,15000US061130104022,660,75,16,22,0,12,16,22,644,79,110,57,534,86,23074
4074,4074,15000US061130105011,1033,136,41,51,10,14,31,49,992,147,41,34,951,149,23075
4075,4075,15000US061130105012,241,60,48,32,14,21,34,35,193,60,8,14,185,59,23076
4076,4076,15000US061130105051,296,52,0,12,0,12,0,12,296,52,52,35,244,60,23077
4077,4077,15000US061130105052,66,28,0,12,0,12,0,12,66,28,26,23,40,37,23078
4078,4078,15000US061130105053,1417,79,46,46,0,12,46,46,1371,84,141,68,1230,102,23079
4079,4079,15000US061130105081,1032,47,0,12,0,12,0,12,1032,47,162,56,870,68,23080
4080,4080,15000US061130105091,551,70,19,20,19,20,0,12,532,69,66,54,466,74,23081
4081,4081,15000US061130105092,756,70,47,34,38,35,9,14,709,70,73,33,636,79,23082
4082,4082,15000US061130105101,226,55,17,27,0,12,17,27,209,59,33,29,176,59,23083
4083,4083,15000US061130105102,960,110,21,30,21,30,0,12,939,108,252,86,687,109,23084
4084,4084,15000US061130105103,463,113,0,12,0,12,0,12,463,113,43,45,420,120,23085
4085,4085,15000US061130105104,392,61,0,12,0,12,0,12,392,61,44,42,348,60,23086
4086,4086,15000US061130105111,445,73,0,12,0,12,0,12,445,73,38,27,407,77,23087
4087,4087,15000US061130105112,897,85,18,20,0,12,18,20,879,85,212,69,667,95,23088
4088,4088,15000US061130105121,590,75,34,33,0,12,34,33,556,84,80,49,476,80,23089
4089,4089,15000US061130105122,587,83,7,11,0,12,7,11,580,84,82,42,498,89,23090
4090,4090,15000US061130105131,536,72,9,14,0,12,9,14,527,73,35,26,492,75,23091
4091,4091,15000US061130105132,589,77,72,50,0,12,72,50,517,84,17,19,500,87,23092
4092,4092,15000US061130106021,1152,190,72,53,14,21,58,48,1080,178,111,69,969,184,23093
4093,4093,15000US061130106022,496,117,0,12,0,12,0,12,496,117,135,101,361,88,23094
4094,4094,15000US061130106023,359,116,11,20,0,12,11,20,348,117,40,45,308,111,23095
4095,4095,15000US061130106024,581,160,104,110,12,21,92,109,477,128,64,79,413,116,23096
4096,4096,15000US061130106051,802,71,65,63,0,12,65,63,737,75,75,34,662,75,23097
4097,4097,15000US061130106052,358,66,9,15,9,15,0,12,349,64,38,23,311,66,23098
4098,4098,15000US061130106061,532,92,22,26,13,20,9,16,510,98,32,38,478,102,23099
4099,4099,15000US061130106062,640,110,0,12,0,12,0,12,640,110,127,85,513,113,23100
4100,4100,15000US061130106063,317,62,20,32,20,32,0,12,297,58,90,58,207,67,23101
4101,4101,15000US061130106064,1112,136,103,78,35,33,68,76,1009,123,202,80,807,128,23102
4102,4102,15000US061130106065,249,73,0,12,0,12,0,12,249,73,37,40,212,71,23103
4103,4103,15000US061130106071,582,82,17,22,6,10,11,18,565,83,73,45,492,80,23104
4104,4104,15000US061130106072,245,53,0,12,0,12,0,12,245,53,56,34,189,48,23105
4105,4105,15000US061130106073,790,70,17,26,0,12,17,26,773,65,163,67,610,83,23106
4106,4106,15000US061130106081,480,70,12,16,12,16,0,12,468,71,37,26,431,71,23107
4107,4107,15000US061130106082,1025,119,97,68,0,12,97,68,928,118,106,42,822,116,23108
4108,4108,15000US061130106083,275,53,8,14,0,12,8,14,267,54,33,26,234,54,23109
4109,4109,15000US061130107011,404,75,0,12,0,12,0,12,404,75,37,36,367,79,23110
4110,4110,15000US061130107012,940,166,18,31,0,12,18,31,922,167,24,26,898,162,23111
4111,4111,15000US061130107013,367,112,0,12,0,12,0,12,367,112,44,38,323,111,23112
4112,4112,15000US061130107014,341,93,0,12,0,12,0,12,341,93,38,34,303,94,23113
4113,4113,15000US061130107031,221,63,8,13,0,12,8,13,213,66,17,20,196,66,23114
4114,4114,15000US061130107032,677,99,0,12,0,12,0,12,677,99,93,46,584,106,23115
4115,4115,15000US061130107033,359,84,39,50,0,12,39,50,320,74,41,31,279,78,23116
4116,4116,15000US061130107034,431,74,0,12,0,12,0,12,431,74,66,40,365,80,23117
4117,4117,15000US061130107041,876,58,47,24,4,7,43,25,829,53,136,38,693,62,23118
4118,4118,15000US061130108001,632,108,112,72,52,42,60,58,520,103,166,77,354,99,23119
4119,4119,15000US061130108002,359,76,82,53,14,15,68,53,277,70,69,34,208,70,23120
4120,4120,15000US061130108003,339,84,31,34,31,34,0,12,308,90,107,67,201,75,23121
4121,4121,15000US061130109011,666,93,42,33,16,19,26,24,624,96,108,51,516,95,23122
4122,4122,15000US061130109012,347,73,58,34,40,26,18,19,289,76,125,56,164,72,23123
4123,4123,15000US061130109013,761,96,94,68,52,55,42,42,667,105,229,75,438,100,23124
4124,4124,15000US061130109021,841,123,135,72,40,35,95,65,706,132,142,87,564,147,23125
4125,4125,15000US061130109022,890,125,170,92,59,54,111,80,720,128,252,105,468,121,23126
4126,4126,15000US061130109023,599,122,34,40,0,12,34,40,565,130,141,77,424,130,23127
4127,4127,15000US061130110011,854,176,71,64,30,36,41,56,783,168,202,91,581,172,23128
4128,4128,15000US061130110012,913,157,179,90,42,43,137,79,734,159,163,101,571,152,23129
4129,4129,15000US061130110013,703,152,264,115,48,41,216,113,439,123,73,48,366,120,23130
4130,4130,15000US061130110021,551,75,10,15,10,15,0,12,541,77,215,69,326,82,23131
4131,4131,15000US061130110022,481,73,20,22,20,22,0,12,461,74,132,54,329,76,23132
4132,4132,15000US061130110023,432,66,17,21,0,12,17,21,415,67,105,50,310,69,23133
4133,4133,15000US061130111011,562,80,58,42,30,26,28,33,504,79,155,63,349,85,23134
4134,4134,15000US061130111012,553,80,62,61,11,17,51,60,491,78,123,51,368,77,23135
4135,4135,15000US061130111021,855,109,217,87,61,37,156,83,638,115,151,72,487,106,23136
4136,4136,15000US061130111022,653,105,137,75,24,27,113,71,516,105,115,49,401,105,23137
4137,4137,15000US061130111031,543,77,57,42,16,19,41,37,486,75,137,50,349,75,23138
4138,4138,15000US061130111032,380,71,27,23,9,15,18,19,353,75,85,37,268,67,23139
4139,4139,15000US061130112031,589,68,19,30,0,12,19,30,570,71,71,40,499,76,23140
4140,4140,15000US061130112032,461,66,11,17,0,12,11,17,450,68,142,58,308,74,23141
4141,4141,15000US061130112041,754,79,47,32,41,30,6,11,707,85,204,76,503,101,23142
4142,4142,15000US061130112042,675,87,81,56,61,56,20,30,594,85,144,54,450,97,23143
4143,4143,15000US061130112043,440,72,18,22,0,12,18,22,422,74,128,55,294,79,23144
4144,4144,15000US061130112051,841,136,71,55,36,41,35,39,770,136,156,93,614,134,23145
4145,4145,15000US061130112052,402,105,0,12,0,12,0,12,402,105,94,64,308,100,23146
4146,4146,15000US061130112053,389,121,18,29,0,12,18,29,371,128,59,69,312,123,23147
4147,4147,15000US061130112054,454,122,48,56,0,12,48,56,406,123,35,33,371,126,23148
4148,4148,15000US061130112055,426,87,9,15,9,15,0,12,417,90,35,41,382,94,23149
4149,4149,15000US061130112061,309,91,35,43,35,43,0,12,274,95,54,57,220,86,23150
4150,4150,15000US061130112062,873,159,40,46,40,46,0,12,833,157,269,114,564,159,23151
4151,4151,15000US061130112063,1288,152,22,36,0,12,22,36,1266,156,195,104,1071,150,23152
4152,4152,15000US061130113001,571,169,6,12,0,12,6,12,565,168,81,60,484,167,23153
4153,4153,15000US061130113002,310,121,45,42,17,26,28,33,265,121,102,102,163,71,23154
4154,4154,15000US061130113003,1018,163,125,82,33,39,92,74,893,162,221,95,672,159,23155
4155,4155,15000US061130113004,791,148,0,12,0,12,0,12,791,148,145,115,646,164,23156
4156,4156,15000US061130113005,267,108,7,12,7,12,0,12,260,107,52,42,208,103,23157
4157,4157,15000US061130114001,333,78,49,39,9,13,40,37,284,77,110,49,174,68,23158
4158,4158,15000US061130114002,690,101,121,62,66,53,55,36,569,103,208,74,361,97,23159
4159,4159,15000US061130114003,466,89,15,20,0,12,15,20,451,87,136,60,315,89,23160
4160,4160,15000US061130115001,231,69,0,12,0,12,0,12,231,69,108,51,123,54,23161
4161,4161,15000US061130115002,396,118,17,28,0,12,17,28,379,120,100,64,279,108,23162
4162,4162,15000US061130115003,765,103,121,60,35,29,86,52,644,118,145,60,499,119,23163
4163,4163,15000US061130115004,250,86,5,9,0,12,5,9,245,86,113,57,132,66,23164
4164,4164,15000US061130115005,238,70,33,31,10,15,23,26,205,67,68,47,137,64,23165
4165,4165,15000US061150401001,306,56,44,37,29,27,15,23,262,58,107,52,155,62,23166
4166,4166,15000US061150401002,331,82,37,35,0,12,37,35,294,80,25,19,269,78,23167
4167,4167,15000US061150401003,454,101,96,56,38,43,58,39,358,94,151,76,207,82,23168
4168,4168,15000US061150401004,374,102,99,69,70,62,29,32,275,89,115,66,160,80,23169
4169,4169,15000US061150401005,313,79,81,57,32,40,49,42,232,85,87,54,145,70,23170
4170,4170,15000US061150402001,264,80,7,12,0,12,7,12,257,79,59,48,198,84,23171
4171,4171,15000US061150402002,724,169,188,114,64,52,124,103,536,194,162,93,374,182,23172
4172,4172,15000US061150402003,394,126,7,12,0,12,7,12,387,126,222,118,165,79,23173
4173,4173,15000US061150402004,337,126,22,28,9,16,13,22,315,127,36,28,279,127,23174
4174,4174,15000US061150402005,414,133,41,40,25,29,16,27,373,141,101,61,272,133,23175
4175,4175,15000US061150402006,392,128,160,106,64,61,96,94,232,128,50,45,182,126,23176
4176,4176,15000US061150402007,343,104,21,35,0,12,21,35,322,102,150,99,172,94,23177
4177,4177,15000US061150403011,1174,106,475,97,225,89,250,94,699,117,279,84,420,100,23178
4178,4178,15000US061150403021,743,54,325,72,161,62,164,59,418,72,143,47,275,67,23179
4179,4179,15000US061150403031,2009,165,232,119,126,81,106,91,1777,215,265,111,1512,210,23180
4180,4180,15000US061150403032,442,120,75,46,56,39,19,31,367,118,182,113,185,92,23181
4181,4181,15000US061150404001,609,121,191,81,99,55,92,62,418,107,176,90,242,89,23182
4182,4182,15000US061150404002,525,109,254,100,174,89,80,68,271,93,97,47,174,73,23183
4183,4183,15000US061150404003,544,96,135,66,61,46,74,50,409,103,272,71,137,78,23184
4184,4184,15000US061150405001,379,111,33,27,19,17,14,23,346,111,154,101,192,82,23185
4185,4185,15000US061150405002,527,107,124,66,76,59,48,35,403,109,230,92,173,73,23186
4186,4186,15000US061150405003,317,83,68,45,54,40,14,19,249,85,86,52,163,79,23187
4187,4187,15000US061150406001,489,130,122,72,47,45,75,61,367,123,143,75,224,91,23188
4188,4188,15000US061150406002,283,79,23,29,23,29,0,12,260,74,127,48,133,68,23189
4189,4189,15000US061150406003,445,125,160,104,21,24,139,107,285,89,115,69,170,70,23190
4190,4190,15000US061150406004,279,82,59,57,48,56,11,16,220,75,128,62,92,54,23191
4191,4191,15000US061150406005,416,102,88,55,60,55,28,34,328,105,85,53,243,97,23192
4192,4192,15000US061150407001,544,97,46,43,0,12,46,43,498,89,169,73,329,90,23193
4193,4193,15000US061150407002,1002,157,93,64,38,41,55,61,909,171,203,104,706,170,23194
4194,4194,15000US061150407003,231,105,0,12,0,12,0,12,231,105,89,57,142,101,23195
4195,4195,15000US061150407004,849,148,0,12,0,12,0,12,849,148,186,89,663,137,23196
4196,4196,15000US061150407005,1218,169,44,38,22,24,22,29,1174,169,198,74,976,167,23197
4197,4197,15000US061150408001,866,100,117,71,75,68,42,39,749,96,222,95,527,108,23198
4198,4198,15000US061150408002,178,87,19,22,0,12,19,22,159,88,134,83,25,33,23199
4199,4199,15000US061150408003,446,88,6,13,0,12,6,13,440,90,96,55,344,80,23200
4200,4200,15000US061150409011,599,79,96,59,46,38,50,48,503,66,145,58,358,79,23201
4201,4201,15000US061150409012,449,70,110,47,72,44,38,25,339,66,138,47,201,55,23202
4202,4202,15000US061150409021,145,43,12,10,4,6,8,8,133,44,7,8,126,43,23203
4203,4203,15000US061150409022,12,10,6,9,0,12,6,9,6,6,4,5,2,4,23204
4204,4204,15000US061150409023,212,56,13,16,0,12,13,16,199,57,21,16,178,59,23205
4205,4205,15000US061150410001,882,170,44,41,44,41,0,12,838,177,191,86,647,188,23206
4206,4206,15000US061150410002,808,173,124,71,56,68,68,70,684,165,300,138,384,144,23207
4207,4207,15000US061150410003,526,140,29,35,29,35,0,12,497,148,78,47,419,156,23208
4208,4208,15000US061150410004,441,121,76,55,15,23,61,50,365,116,112,70,253,102,23209
4209,4209,15000US061150410005,259,77,14,21,14,21,0,12,245,78,104,73,141,61,23210
4210,4210,15000US061150411001,503,91,25,17,12,10,13,14,478,91,167,53,311,91,23211
4211,4211,15000US061150411002,806,174,96,93,0,12,96,93,710,167,248,138,462,147,23212
4212,4212,15000US061150411003,561,177,33,39,33,39,0,12,528,172,134,91,394,153,23213
4213,4213,15000US061150411004,291,125,37,27,37,27,0,12,254,132,84,76,170,109,23214
